AAAAAGACAAA -> AAAAGACAAAA
AAAAAGGGTCC -> AAAAGGGTCCG
AAAACACACCT -> AAACACACCTA
AAAACGCCAAA -> AAACGCCAAAG
AAAAGACAAAA -> AAAGACAAAAC
AAAAGGGTCCG -> AAAGGGTCCGT
AAAATACCGTG -> AAATACCGTGT
AAAATCAAGAT -> AAATCAAGATT
AAAATCCTCTA -> AAATCCTCTAA
AAACACACCTA -> AACACACCTAC
AAACAGGGGGT -> AACAGGGGGTA
AAACCAGCAGA -> AACCAGCAGAG
AAACCCTAGTC -> AACCCTAGTCT
AAACCGTCGCT -> AACCGTCGCTC
AAACGCCAAAG -> AACGCCAAAGG
AAAGAAAGGTG -> AAGAAAGGTGG
AAAGACAAAAC -> AAGACAAAACA
AAAGAGTATCT -> AAGAGTATCTA
AAAGCCGGAAA -> AAGCCGGAAAG
AAAGCGGCTGC -> AAGCGGCTGCG
AAAGGCATTAT -> AAGGCATTATT
AAAGGGGCTCC -> AAGGGGCTCCT
AAAGGGTCCGT -> AAGGGTCCGTA
AAAGGTGGTAC -> AAGGTGGTACT
AAAGGTTTTTT -> AAGGTTTTTTC
AAAGTCTCAGG -> AAGTCTCAGGC
AAATACCGTGT -> AATACCGTGTG
AAATCAAGATT -> AATCAAGATTC
AAATCCGGTTA -> AATCCGGTTAT
AAATCCTCTAA -> AATCCTCTAAA
AAATCGTCGCT -> AATCGTCGCTA
AACAAGGGGGA -> ACAAGGGGGAG
AACAAGTAACG -> ACAAGTAACGG
AACAATCACAT -> ACAATCACATT
AACACACCTAC -> ACACACCTACT
AACACGGTTTG -> ACACGGTTTGA
AACAGGGGGTA -> ACAGGGGGTAC
AACCAGCAGAG -> ACCAGCAGAGC
AACCATAACTG -> ACCATAACTGC
AACCATGAGTC -> ACCATGAGTCC
AACCCTAGTCT -> ACCCTAGTCTT
AACCGATCTAA -> ACCGATCTAAG
AACCGGATGGT -> ACCGGATGGTC
AACCGTCGCTC -> ACCGTCGCTCG
AACCTCCTATC -> ACCTCCTATCC
AACCTTGTATG -> ACCTTGTATGC
AACGCCAAAGG -> ACGCCAAAGGT
AACGCGCTCTT -> ACGCGCTCTTT
AACGGCACTGC -> ACGGCACTGCC
AACTAAATCCG -> ACTAAATCCGG
AACTACCCCTA -> ACTACCCCTAT
AACTATGACCA -> ACTATGACCAA
AACTATTTTAG -> ACTATTTTAGG
AACTCAAGCGT -> ACTCAAGCGTC
AACTGCAGTTG -> ACTGCAGTTGG
AACTGCCACCC -> ACTGCCACCCG
AACTGGCTAAG -> ACTGGCTAAGG
AAGAAAGGTGG -> AGAAAGGTGGT
AAGAACCATAA -> AGAACCATAAC
AAGACAAAACA -> AGACAAAACAC
AAGAGTATCTA -> AGAGTATCTAC
AAGATTCGATA -> AGATTCGATAA
AAGCAGCTCCC -> AGCAGCTCCCA
AAGCCAAAGCC -> AGCCAAAGCCG
AAGCCAATAAA -> AGCCAATAAAA
AAGCCGGAAAG -> AGCCGGAAAGG
AAGCCTGAAGT -> AGCCTGAAGTT
AAGCGGCTGCG -> AGCGGCTGCGC
AAGCGTCTTGG -> AGCGTCTTGGT
AAGCTTAGAGT -> AGCTTAGAGTC
AAGGAGCGGAT -> AGGAGCGGATC
AAGGCATTATT -> AGGCATTATTC
AAGGCGACCAT -> AGGCGACCATC
AAGGGAAGGGT -> AGGGAAGGGTA
AAGGGCTCTTC -> AGGGCTCTTCT
AAGGGGCTCCT -> AGGGGCTCCTT
AAGGGGGAGCT -> AGGGGGAGCTA
AAGGGTAAAGC -> AGGGTAAAGCG
AAGGGTCCGTA -> AGGGTCCGTAG
AAGGTGATGCA -> AGGTGATGCAG
AAGGTGCATTC -> AGGTGCATTCC
AAGGTGGTACT -> AGGTGGTACTC
AAGGTTGAGGC -> AGGTTGAGGCG
AAGGTTTTTTC -> AGGTTTTTTCT
AAGTAACGGCA -> AGTAACGGCAC
AAGTAGATAAT -> AGTAGATAATA
AAGTCCAACTG -> AGTCCAACTGG
AAGTCTCAGGC -> AGTCTCAGGCC
AAGTGGGCTAC -> AGTGGGCTACC
AAGTTGCTCGT -> AGTTGCTCGTG
AAGTTTGGAGA -> AGTTTGGAGAC
AAGTTTGTAAC -> AGTTTGTAACT
AATAAAAAGAC -> ATAAAAAGACA
AATAAAAAGGG -> ATAAAAAGGGT
AATACAAAGGC -> ATACAAAGGCA
AATACCGTGTG -> ATACCGTGTGC
AATATCATGAT -> ATATCATGATA
AATCAAGATTC -> ATCAAGATTCG
AATCACATTAT -> ATCACATTATC
AATCCGATTCC -> ATCCGATTCCT
AATCCGGTTAT -> ATCCGGTTATC
AATCCTCTAAA -> ATCCTCTAAAC
AATCGGTGCAG -> ATCGGTGCAGA
AATCGTCGCTA -> ATCGTCGCTAT
AATCTCGATGT -> ATCTCGATGTT
AATGCCGGAGT -> ATGCCGGAGTA
AATGTCGTCGG -> ATGTCGTCGGC
AATTATGGTGC -> ATTATGGTGCA
AATTCCGACGA -> ATTCCGACGAG
AATTTGGAGGC -> ATTTGGAGGCA
ACAAAACACAC -> CAAAACACACC
ACAAAGGCATT -> CAAAGGCATTA
ACAACCTTGTA -> CAACCTTGTAT
ACAAGGGGGAG -> CAAGGGGGAGC
ACAAGTAACGG -> CAAGTAACGGC
ACAAGTGGGCT -> CAAGTGGGCTA
ACAATCACATT -> CAATCACATTA
ACACAACCTTG -> CACAACCTTGT
ACACACCTACT -> CACACCTACTG
ACACACTACAT -> CACACTACATT
ACACATCGAGT -> CACATCGAGTC
ACACCTACTGC -> CACCTACTGCA
ACACGCACCAC -> CACGCACCACG
ACACGCGACGC -> CACGCGACGCG
ACACGGTTTGA -> CACGGTTTGAT
ACACGTTCGCG -> CACGTTCGCGA
ACACTACATTA -> CACTACATTAC
ACACTCCTATT -> CACTCCTATTA
ACAGCTCAACA -> CAGCTCAACAA
ACAGGGGGTAC -> CAGGGGGTACA
ACAGTAACTAA -> CAGTAACTAAA
ACAGTCAGCCA -> CAGTCAGCCAT
ACAGTGACGAT -> CAGTGACGATA
ACATACGGAGC -> CATACGGAGCA
ACATCGAGTCC -> CATCGAGTCCA
ACATTACTGCC -> CATTACTGCCT
ACATTATCGTT -> CATTATCGTTA
ACCAAAGAGTA -> CCAAAGAGTAT
ACCACACGCGA -> CCACACGCGAC
ACCACGGTTGC -> CCACGGTTGCG
ACCACTGGCCT -> CCACTGGCCTG
ACCAGACTCGA -> CCAGACTCGAC
ACCAGAGTCTG -> CCAGAGTCTGG
ACCAGCAGAGC -> CCAGCAGAGCG
ACCATAACTGC -> CCATAACTGCC
ACCATCACCCG -> CCATCACCCGC
ACCATCTGCTA -> CCATCTGCTAC
ACCATGAGTCC -> CCATGAGTCCA
ACCCCCATTCT -> CCCCCATTCTC
ACCCCTATGAG -> CCCCTATGAGA
ACCCGACAGCT -> CCCGACAGCTC
ACCCGATGTCG -> CCCGATGTCGT
ACCCGCGAATG -> CCCGCGAATGT
ACCCGTGCGTC -> CCCGTGCGTCG
ACCCTACCTCA -> CCCTACCTCAA
ACCCTAGTCTT -> CCCTAGTCTTT
ACCGAGTTGCG -> CCGAGTTGCGT
ACCGATCTAAG -> CCGATCTAAGC
ACCGGATGGTC -> CCGGATGGTCG
ACCGGCGGTCC -> CCGGCGGTCCG
ACCGTCGCTCG -> CCGTCGCTCGG
ACCGTCTTCAT -> CCGTCTTCATC
ACCGTGCTCGG -> CCGTGCTCGGT
ACCGTGTGCAA -> CCGTGTGCAAC
ACCTACTGCAC -> CCTACTGCACG
ACCTCAATTTG -> CCTCAATTTGG
ACCTCCCATCT -> CCTCCCATCTG
ACCTCCTATCC -> CCTCCTATCCG
ACCTTCATTGT -> CCTTCATTGTG
ACCTTGTATGC -> CCTTGTATGCC
ACGAACAAGGG -> CGAACAAGGGG
ACGAACTATGA -> CGAACTATGAC
ACGAAGGGAAG -> CGAAGGGAAGG
ACGAAGGTGAT -> CGAAGGTGATG
ACGACCAGAGT -> CGACCAGAGTC
ACGACTAGGAA -> CGACTAGGAAG
ACGAGGGCTTT -> CGAGGGCTTTC
ACGAGTACCCT -> CGAGTACCCTA
ACGATAGTATT -> CGATAGTATTA
ACGCAAAATAC -> CGCAAAATACC
ACGCAAAGAAA -> CGCAAAGAAAG
ACGCACCACGG -> CGCACCACGGT
ACGCCAAAGGT -> CGCCAAAGGTT
ACGCCCGCTAT -> CGCCCGCTATC
ACGCCCTTCCA -> CGCCCTTCCAA
ACGCCGGTACA -> CGCCGGTACAC
ACGCGACGCGT -> CGCGACGCGTC
ACGCGCGGAGG -> CGCGCGGAGGA
ACGCGCTCTTT -> CGCGCTCTTTG
ACGCGGGGCCG -> CGCGGGGCCGT
ACGCGTCGCTA -> CGCGTCGCTAT
ACGCTCACATA -> CGCTCACATAC
ACGGAGCAGTA -> CGGAGCAGTAG
ACGGCACTGCC -> CGGCACTGCCA
ACGGCAGAGCC -> CGGCAGAGCCG
ACGGCTATTAG -> CGGCTATTAGG
ACGGGTACTAA -> CGGGTACTAAT
ACGGTTGCGAA -> CGGTTGCGAAC
ACGGTTTGATA -> CGGTTTGATAG
ACGTCATTGGA -> CGTCATTGGAT
ACGTCCACTAG -> CGTCCACTAGC
ACGTTCGCGAA -> CGTTCGCGAAG
ACGTTCTCATT -> CGTTCTCATTG
ACTAAATCCGG -> CTAAATCCGGT
ACTAATCCGAT -> CTAATCCGATT
ACTACATTACT -> CTACATTACTG
ACTACCCCTAT -> CTACCCCTATG
ACTAGCGCGCT -> CTAGCGCGCTT
ACTAGGAAGCT -> CTAGGAAGCTT
ACTAGGACGAA -> CTAGGACGAAC
ACTATGACCAA -> CTATGACCAAA
ACTATTTTAGG -> CTATTTTAGGT
ACTCAAGCGTC -> CTCAAGCGTCT
ACTCCTATTAA -> CTCCTATTAAC
ACTCGACCATC -> CTCGACCATCA
ACTCTACGCGG -> CTCTACGCGGG
ACTCTACGGCA -> CTCTACGGCAG
ACTGCAACACG -> CTGCAACACGG
ACTGCACGTCC -> CTGCACGTCCA
ACTGCAGTTGG -> CTGCAGTTGGC
ACTGCCACCCG -> CTGCCACCCGA
ACTGCCAGATT -> CTGCCAGATTT
ACTGCCTTTGT -> CTGCCTTTGTT
ACTGGCCTGAA -> CTGGCCTGAAA
ACTGGCTAAGG -> CTGGCTAAGGC
ACTGTATGCGG -> CTGTATGCGGG
ACTTCGCGTTA -> CTTCGCGTTAC
ACTTCTGCGCT -> CTTCTGCGCTC
AGAAAGGTGGT -> GAAAGGTGGTA
AGAACCATAAC -> GAACCATAACT
AGAACTCAAGC -> GAACTCAAGCG
AGAAGGGCTCT -> GAAGGGCTCTT
AGAAGGTGCAT -> GAAGGTGCATT
AGAAGTTGCTC -> GAAGTTGCTCG
AGAATACAAAG -> GAATACAAAGG
AGACAAAACAC -> GACAAAACACA
AGACGAACTAT -> GACGAACTATG
AGACGAAGGGA -> GACGAAGGGAA
AGACGCCCTTC -> GACGCCCTTCC
AGACTAGGACG -> GACTAGGACGA
AGACTCGACCA -> GACTCGACCAT
AGACTGTATGC -> GACTGTATGCG
AGACTTCGCGT -> GACTTCGCGTT
AGAGAAGGGCT -> GAGAAGGGCTC
AGAGAAGGTGC -> GAGAAGGTGCA
AGAGACGAACT -> GAGACGAACTA
AGAGAGGCAAA -> GAGAGGCAAAC
AGAGATGTCTA -> GAGATGTCTAT
AGAGCCGTAGA -> GAGCCGTAGAC
AGAGCGCAGTT -> GAGCGCAGTTA
AGAGCGCTTTT -> GAGCGCTTTTA
AGAGGCAAACC -> GAGGCAAACCA
AGAGGGACCAC -> GAGGGACCACA
AGAGTATCTAC -> GAGTATCTACT
AGAGTCGCAAT -> GAGTCGCAATC
AGAGTCTGGCA -> GAGTCTGGCAA
AGATAATATCA -> GATAATATCAT
AGATGAACTGC -> GATGAACTGCA
AGATGTCTATT -> GATGTCTATTC
AGATTCGATAA -> GATTCGATAAA
AGATTTTGGGC -> GATTTTGGGCG
AGCACCGAGTT -> GCACCGAGTTG
AGCACGCCCGC -> GCACGCCCGCT
AGCACGGCTAT -> GCACGGCTATT
AGCACTTCTGC -> GCACTTCTGCG
AGCAGAGCGCA -> GCAGAGCGCAG
AGCAGCTCCCA -> GCAGCTCCCAT
AGCAGCTCTCT -> GCAGCTCTCTT
AGCAGTAGTTC -> GCAGTAGTTCC
AGCCAAAGCCG -> GCCAAAGCCGG
AGCCAATAAAA -> GCCAATAAAAA
AGCCAGCTTGC -> GCCAGCTTGCA
AGCCATTGCAG -> GCCATTGCAGA
AGCCGAATCGG -> GCCGAATCGGT
AGCCGGAAAGG -> GCCGGAAAGGG
AGCCGTAGACT -> GCCGTAGACTT
AGCCTGAAGTT -> GCCTGAAGTTT
AGCGCAGTTAG -> GCGCAGTTAGC
AGCGCCCGAAG -> GCGCCCGAAGT
AGCGCGCGGTC -> GCGCGCGGTCG
AGCGCGCTTTG -> GCGCGCTTTGT
AGCGCTTTTAT -> GCGCTTTTATG
AGCGGATCAGC -> GCGGATCAGCT
AGCGGCTGCGC -> GCGGCTGCGCA
AGCGTCTTGGT -> GCGTCTTGGTA
AGCTAACAAGT -> GCTAACAAGTA
AGCTAGAGAGG -> GCTAGAGAGGC
AGCTCAACAAT -> GCTCAACAATC
AGCTCCCATCC -> GCTCCCATCCG
AGCTCTCTTAG -> GCTCTCTTAGA
AGCTGGCTTCC -> GCTGGCTTCCA
AGCTTAGAGTC -> GCTTAGAGTCG
AGCTTGCATCA -> GCTTGCATCAC
AGCTTTATGTA -> GCTTTATGTAA
AGGAAAATCCT -> GGAAAATCCTC
AGGAAGCTTAG -> GGAAGCTTAGA
AGGACGAACAA -> GGACGAACAAG
AGGAGAGCGCT -> GGAGAGCGCTT
AGGAGCGGATC -> GGAGCGGATCA
AGGAGTGTCTG -> GGAGTGTCTGT
AGGATCAGTTC -> GGATCAGTTCG
AGGCAAACCAG -> GGCAAACCAGC
AGGCAGGCGTG -> GGCAGGCGTGG
AGGCATTATTC -> GGCATTATTCC
AGGCCACCAGA -> GGCCACCAGAC
AGGCGACCATC -> GGCGACCATCT
AGGCGCAGTCC -> GGCGCAGTCCT
AGGCGGCTAGA -> GGCGGCTAGAC
AGGCGTGGCGC -> GGCGTGGCGCA
AGGGAAGGGTA -> GGGAAGGGTAA
AGGGACCACAC -> GGGACCACACG
AGGGCTCTTCT -> GGGCTCTTCTA
AGGGCTTTCGA -> GGGCTTTCGAG
AGGGGATCGGC -> GGGGATCGGCG
AGGGGCTACAC -> GGGGCTACACG
AGGGGCTCCTT -> GGGGCTCCTTG
AGGGGGAGCTA -> GGGGGAGCTAA
AGGGGGTACAG -> GGGGGTACAGT
AGGGTAAAGCG -> GGGTAAAGCGG
AGGGTCCGTAG -> GGGTCCGTAGG
AGGTGATGCAG -> GGTGATGCAGG
AGGTGCATTCC -> GGTGCATTCCT
AGGTGGTACTC -> GGTGGTACTCT
AGGTGGTAGAG -> GGTGGTAGAGA
AGGTTATCACC -> GGTTATCACCT
AGGTTGAGGCG -> GGTTGAGGCGC
AGGTTTTTTCT -> GGTTTTTTCTG
AGTAACGGCAC -> GTAACGGCACT
AGTAACTAAAT -> GTAACTAAATC
AGTACCCTACC -> GTACCCTACCT
AGTACGCGCGG -> GTACGCGCGGA
AGTAGATAATA -> GTAGATAATAT
AGTAGCACGGC -> GTAGCACGGCT
AGTAGTTCCCG -> GTAGTTCCCGA
AGTATCTACTC -> GTATCTACTCT
AGTATTAGTGA -> GTATTAGTGAT
AGTCAGCCATT -> GTCAGCCATTG
AGTCAGCTTTA -> GTCAGCTTTAT
AGTCCAACCTC -> GTCCAACCTCC
AGTCCAACTGG -> GTCCAACTGGC
AGTCCAATTAT -> GTCCAATTATG
AGTCCTCAAGA -> GTCCTCAAGAA
AGTCGCAATCT -> GTCGCAATCTC
AGTCTCAGGCC -> GTCTCAGGCCC
AGTCTGGCAAG -> GTCTGGCAAGT
AGTCTTTCCTA -> GTCTTTCCTAC
AGTGACGATAG -> GTGACGATAGT
AGTGATCATCT -> GTGATCATCTT
AGTGGCAGCGC -> GTGGCAGCGCC
AGTGGGCTACC -> GTGGGCTACCA
AGTGTCTGTAC -> GTGTCTGTACA
AGTTAGCCAGC -> GTTAGCCAGCT
AGTTCCCGATC -> GTTCCCGATCG
AGTTCGGCAGC -> GTTCGGCAGCA
AGTTGCGTCAC -> GTTGCGTCACA
AGTTGCTCGTG -> GTTGCTCGTGG
AGTTGGCATTT -> GTTGGCATTTC
AGTTTGGAGAC -> GTTTGGAGACG
AGTTTGTAACT -> GTTTGTAACTA
ATAAAAAGACA -> TAAAAAGACAA
ATAAAAAGGGT -> TAAAAAGGGTC
ATAAACCCTAG -> TAAACCCTAGT
ATAACTGCCAC -> TAACTGCCACC
ATAATATCATG -> TAATATCATGA
ATACAAAGGCA -> TACAAAGGCAT
ATACCGTGTGC -> TACCGTGTGCA
ATACGGAGCAG -> TACGGAGCAGT
ATAGCACGCCC -> TAGCACGCCCG
ATAGGCCACCA -> TAGGCCACCAG
ATAGTATTAGT -> TAGTATTAGTG
ATATCATGATA -> TATCATGATAG
ATCAAAATCAA -> TCAAAATCAAG
ATCAAGATTCG -> TCAAGATTCGA
ATCACATTATC -> TCACATTATCG
ATCACCCGCGA -> TCACCCGCGAA
ATCACCTTCAT -> TCACCTTCATT
ATCACGGGTAC -> TCACGGGTACT
ATCACGTCATT -> TCACGTCATTG
ATCAGCTAGAG -> TCAGCTAGAGA
ATCAGTTCGGC -> TCAGTTCGGCA
ATCATCTTTTT -> TCATCTTTTTC
ATCATGATAGC -> TCATGATAGCA
ATCCGATTCCT -> TCCGATTCCTC
ATCCGCAGACG -> TCCGCAGACGA
ATCCGGTTATC -> TCCGGTTATCG
ATCCGTCAGCT -> TCCGTCAGCTG
ATCCTCTAAAC -> TCCTCTAAACC
ATCGAACCGAT -> TCGAACCGATC
ATCGAGGAAAA -> TCGAGGAAAAT
ATCGAGGGGCT -> TCGAGGGGCTA
ATCGAGTCCAA -> TCGAGTCCAAT
ATCGCATTTGA -> TCGCATTTGAC
ATCGCGTCCCA -> TCGCGTCCCAA
ATCGGCGATTC -> TCGGCGATTCA
ATCGGTGCAGA -> TCGGTGCAGAC
ATCGTCGCTAT -> TCGTCGCTATG
ATCGTTATCTC -> TCGTTATCTCC
ATCTAAGCCAA -> TCTAAGCCAAA
ATCTACTCTAC -> TCTACTCTACG
ATCTCCAGTCA -> TCTCCAGTCAG
ATCTCGATGTT -> TCTCGATGTTT
ATCTGACAAGT -> TCTGACAAGTG
ATCTGCTACCG -> TCTGCTACCGT
ATCTGGAGAGG -> TCTGGAGAGGG
ATCTGGCTTCC -> TCTGGCTTCCC
ATCTTCATGTT -> TCTTCATGTTC
ATCTTTTTCAG -> TCTTTTTCAGT
ATGAACTGCAG -> TGAACTGCAGT
ATGACCAAAGA -> TGACCAAAGAG
ATGAGAGAAGG -> TGAGAGAAGGG
ATGAGAGATGT -> TGAGAGATGTC
ATGAGCACTTC -> TGAGCACTTCT
ATGAGTCCAAC -> TGAGTCCAACC
ATGATAGCACG -> TGATAGCACGC
ATGATGAGAGA -> TGATGAGAGAA
ATGCAGGTGGT -> TGCAGGTGGTA
ATGCATCACGT -> TGCATCACGTC
ATGCCCAAAAC -> TGCCCAAAACG
ATGCCGGAGTA -> TGCCGGAGTAC
ATGCGGGTTGA -> TGCGGGTTGAA
ATGCTCCTCGT -> TGCTCCTCGTC
ATGGTCGTGAC -> TGGTCGTGACA
ATGGTGCACGA -> TGGTGCACGAA
ATGTAAGTTTG -> TGTAAGTTTGG
ATGTCGTCGGC -> TGTCGTCGGCT
ATGTCGTGTTC -> TGTCGTGTTCG
ATGTCTATTCG -> TGTCTATTCGC
ATGTGACGCAA -> TGTGACGCAAA
ATGTTCTATTC -> TGTTCTATTCT
ATGTTTTATTT -> TGTTTTATTTG
ATTAACCGGAT -> TTAACCGGATG
ATTACTGCCTT -> TTACTGCCTTT
ATTAGGATCAG -> TTAGGATCAGT
ATTAGTGATCA -> TTAGTGATCAT
ATTATCGTTAT -> TTATCGTTATC
ATTATGGTGCA -> TTATGGTGCAC
ATTATTCCTCT -> TTATTCCTCTA
ATTCATGTGAC -> TTCATGTGACG
ATTCCGACGAG -> TTCCGACGAGT
ATTCCTCCAGC -> TTCCTCCAGCG
ATTCCTCTACA -> TTCCTCTACAG
ATTCCTGTCTG -> TTCCTGTCTGC
ATTCGATAAAC -> TTCGATAAACC
ATTCGCCCCTC -> TTCGCCCCTCC
ATTCTCGCTTA -> TTCTCGCTTAA
ATTCTGGTGCC -> TTCTGGTGCCA
ATTGATGCATC -> TTGATGCATCA
ATTGCAGATGA -> TTGCAGATGAA
ATTGGATCTGG -> TTGGATCTGGA
ATTGGCGGAAA -> TTGGCGGAAAT
ATTGTGATTTT -> TTGTGATTTTG
ATTTACCTCCC -> TTTACCTCCCA
ATTTCACGCTC -> TTTCACGCTCA
ATTTGACGACC -> TTTGACGACCA
ATTTGCTAGAA -> TTTGCTAGAAT
ATTTGGAGGCA -> TTTGGAGGCAG
ATTTTAGGTTA -> TTTTAGGTTAT
ATTTTGGGACG -> TTTTGGGACGC
ATTTTGGGCGG -> TTTTGGGCGGA
CAAAACACACC -> AAAACACACCT
CAAAACGCCAA -> AAAACGCCAAA
CAAAATACCGT -> AAAATACCGTG
CAAAATCAAGA -> AAAATCAAGAT
CAAACCAGCAG -> AAACCAGCAGA
CAAAGAAAGGT -> AAAGAAAGGTG
CAAAGAGTATC -> AAAGAGTATCT
CAAAGCCGGAA -> AAAGCCGGAAA
CAAAGGCATTA -> AAAGGCATTAT
CAAAGGTTTTT -> AAAGGTTTTTT
CAACAATCACA -> AACAATCACAT
CAACACGGTTT -> AACACGGTTTG
CAACCTCCTAT -> AACCTCCTATC
CAACCTTGTAT -> AACCTTGTATG
CAACTATTTTA -> AACTATTTTAG
CAACTGGCTAA -> AACTGGCTAAG
CAAGAACCATA -> AAGAACCATAA
CAAGATTCGAT -> AAGATTCGATA
CAAGCAGCTCC -> AAGCAGCTCCC
CAAGCCTGAAG -> AAGCCTGAAGT
CAAGCGTCTTG -> AAGCGTCTTGG
CAAGGGGGAGC -> AAGGGGGAGCT
CAAGTAACGGC -> AAGTAACGGCA
CAAGTCCAACT -> AAGTCCAACTG
CAAGTGGGCTA -> AAGTGGGCTAC
CAATAAAAAGA -> AATAAAAAGAC
CAATAAAAAGG -> AATAAAAAGGG
CAATCACATTA -> AATCACATTAT
CAATCTCGATG -> AATCTCGATGT
CAATGCCGGAG -> AATGCCGGAGT
CAATTATGGTG -> AATTATGGTGC
CAATTTGGAGG -> AATTTGGAGGC
CACAACCTTGT -> ACAACCTTGTA
CACACCTACTG -> ACACCTACTGC
CACACGCGACG -> ACACGCGACGC
CACACTACATT -> ACACTACATTA
CACACTCCTAT -> ACACTCCTATT
CACAGTGACGA -> ACAGTGACGAT
CACATACGGAG -> ACATACGGAGC
CACATCGAGTC -> ACATCGAGTCC
CACATTATCGT -> ACATTATCGTT
CACCACGGTTG -> ACCACGGTTGC
CACCAGACTCG -> ACCAGACTCGA
CACCCGACAGC -> ACCCGACAGCT
CACCCGATGTC -> ACCCGATGTCG
CACCCGCGAAT -> ACCCGCGAATG
CACCCGTGCGT -> ACCCGTGCGTC
CACCGAGTTGC -> ACCGAGTTGCG
CACCGTCTTCA -> ACCGTCTTCAT
CACCTACTGCA -> ACCTACTGCAC
CACCTTCATTG -> ACCTTCATTGT
CACGAAGGTGA -> ACGAAGGTGAT
CACGAGGGCTT -> ACGAGGGCTTT
CACGCACCACG -> ACGCACCACGG
CACGCCCGCTA -> ACGCCCGCTAT
CACGCGACGCG -> ACGCGACGCGT
CACGCTCACAT -> ACGCTCACATA
CACGGCTATTA -> ACGGCTATTAG
CACGGGTACTA -> ACGGGTACTAA
CACGGTTGCGA -> ACGGTTGCGAA
CACGGTTTGAT -> ACGGTTTGATA
CACGTCATTGG -> ACGTCATTGGA
CACGTCCACTA -> ACGTCCACTAG
CACGTTCGCGA -> ACGTTCGCGAA
CACTACATTAC -> ACTACATTACT
CACTAGCGCGC -> ACTAGCGCGCT
CACTCCTATTA -> ACTCCTATTAA
CACTGCCAGAT -> ACTGCCAGATT
CACTGGCCTGA -> ACTGGCCTGAA
CACTTCTGCGC -> ACTTCTGCGCT
CAGACGAAGGG -> AGACGAAGGGA
CAGACTCGACC -> AGACTCGACCA
CAGACTGTATG -> AGACTGTATGC
CAGAGCCGTAG -> AGAGCCGTAGA
CAGAGCGCAGT -> AGAGCGCAGTT
CAGAGTCTGGC -> AGAGTCTGGCA
CAGATGAACTG -> AGATGAACTGC
CAGATTTTGGG -> AGATTTTGGGC
CAGCACCGAGT -> AGCACCGAGTT
CAGCAGAGCGC -> AGCAGAGCGCA
CAGCAGCTCTC -> AGCAGCTCTCT
CAGCCATTGCA -> AGCCATTGCAG
CAGCGCCCGAA -> AGCGCCCGAAG
CAGCGCGCGGT -> AGCGCGCGGTC
CAGCTAGAGAG -> AGCTAGAGAGG
CAGCTCAACAA -> AGCTCAACAAT
CAGCTCCCATC -> AGCTCCCATCC
CAGCTCTCTTA -> AGCTCTCTTAG
CAGCTGGCTTC -> AGCTGGCTTCC
CAGCTTGCATC -> AGCTTGCATCA
CAGCTTTATGT -> AGCTTTATGTA
CAGGCGTGGCG -> AGGCGTGGCGC
CAGGGGGTACA -> AGGGGGTACAG
CAGGTGGTAGA -> AGGTGGTAGAG
CAGTAACTAAA -> AGTAACTAAAT
CAGTAGTTCCC -> AGTAGTTCCCG
CAGTCAGCCAT -> AGTCAGCCATT
CAGTCAGCTTT -> AGTCAGCTTTA
CAGTCCTCAAG -> AGTCCTCAAGA
CAGTGACGATA -> AGTGACGATAG
CAGTGGCAGCG -> AGTGGCAGCGC
CAGTTAGCCAG -> AGTTAGCCAGC
CAGTTCGGCAG -> AGTTCGGCAGC
CAGTTGGCATT -> AGTTGGCATTT
CATAACTGCCA -> ATAACTGCCAC
CATACGGAGCA -> ATACGGAGCAG
CATCACCCGCG -> ATCACCCGCGA
CATCACGGGTA -> ATCACGGGTAC
CATCACGTCAT -> ATCACGTCATT
CATCCGCAGAC -> ATCCGCAGACG
CATCGAGTCCA -> ATCGAGTCCAA
CATCGCGTCCC -> ATCGCGTCCCA
CATCTGACAAG -> ATCTGACAAGT
CATCTGCTACC -> ATCTGCTACCG
CATCTGGCTTC -> ATCTGGCTTCC
CATCTTTTTCA -> ATCTTTTTCAG
CATGAGCACTT -> ATGAGCACTTC
CATGAGTCCAA -> ATGAGTCCAAC
CATGATAGCAC -> ATGATAGCACG
CATGTGACGCA -> ATGTGACGCAA
CATGTTCTATT -> ATGTTCTATTC
CATTACTGCCT -> ATTACTGCCTT
CATTATCGTTA -> ATTATCGTTAT
CATTATTCCTC -> ATTATTCCTCT
CATTCCTGTCT -> ATTCCTGTCTG
CATTCTCGCTT -> ATTCTCGCTTA
CATTGATGCAT -> ATTGATGCATC
CATTGCAGATG -> ATTGCAGATGA
CATTGGATCTG -> ATTGGATCTGG
CATTGTGATTT -> ATTGTGATTTT
CATTTCACGCT -> ATTTCACGCTC
CATTTGACGAC -> ATTTGACGACC
CCAAAACGCCA -> CAAAACGCCAA
CCAAAGAGTAT -> CAAAGAGTATC
CCAAAGCCGGA -> CAAAGCCGGAA
CCAAAGGTTTT -> CAAAGGTTTTT
CCAACCTCCTA -> CAACCTCCTAT
CCAACTGGCTA -> CAACTGGCTAA
CCAAGCCTGAA -> CAAGCCTGAAG
CCAATAAAAAG -> CAATAAAAAGA,CAATAAAAAGG
CCAATTATGGT -> CAATTATGGTG
CCACACGCGAC -> CACACGCGACG
CCACACTCCTA -> CACACTCCTAT
CCACCAGACTC -> CACCAGACTCG
CCACCCGACAG -> CACCCGACAGC
CCACCGTCTTC -> CACCGTCTTCA
CCACGGTTGCG -> CACGGTTGCGA
CCACTAGCGCG -> CACTAGCGCGC
CCACTGGCCTG -> CACTGGCCTGA
CCAGACTCGAC -> CAGACTCGACC
CCAGAGTCTGG -> CAGAGTCTGGC
CCAGATTTTGG -> CAGATTTTGGG
CCAGCAGAGCG -> CAGCAGAGCGC
CCAGCGCGCGG -> CAGCGCGCGGT
CCAGCTTGCAT -> CAGCTTGCATC
CCAGTCAGCTT -> CAGTCAGCTTT
CCATAACTGCC -> CATAACTGCCA
CCATCACCCGC -> CATCACCCGCG
CCATCCGCAGA -> CATCCGCAGAC
CCATCGCGTCC -> CATCGCGTCCC
CCATCTGCTAC -> CATCTGCTACC
CCATCTGGCTT -> CATCTGGCTTC
CCATGAGTCCA -> CATGAGTCCAA
CCATTCTCGCT -> CATTCTCGCTT
CCATTGCAGAT -> CATTGCAGATG
CCCAAAACGCC -> CCAAAACGCCA
CCCAATAAAAA -> CCAATAAAAAG
CCCATCCGCAG -> CCATCCGCAGA
CCCATCTGGCT -> CCATCTGGCTT
CCCATTCTCGC -> CCATTCTCGCT
CCCCATTCTCG -> CCCATTCTCGC
CCCCCATTCTC -> CCCCATTCTCG
CCCCCGGAGAG -> CCCCGGAGAGA
CCCCGGAGAGA -> CCCGGAGAGAA
CCCCTATGAGA -> CCCTATGAGAG
CCCCTCCGATT -> CCCTCCGATTG
CCCGAAGTAGA -> CCGAAGTAGAT
CCCGACAGCTC -> CCGACAGCTCA
CCCGATCGCAT -> CCGATCGCATT
CCCGATGTCGT -> CCGATGTCGTG
CCCGCGAATGT -> CCGCGAATGTC
CCCGCTATCGA -> CCGCTATCGAA
CCCGGAGAGAA -> CCGGAGAGAAG
CCCGTGCGTCG -> CCGTGCGTCGG
CCCTACCTCAA -> CCTACCTCAAT
CCCTAGTCTTT -> CCTAGTCTTTC
CCCTATGAGAG -> CCTATGAGAGA
CCCTCCGATTG -> CCTCCGATTGG
CCCTTCCAAGC -> CCTTCCAAGCC
CCGAAGTAGAT -> CGAAGTAGATA
CCGAATCGGTG -> CGAATCGGTGC
CCGACAGCTCA -> CGACAGCTCAA
CCGACGAGTAC -> CGACGAGTACC
CCGAGTTGCGT -> CGAGTTGCGTC
CCGATCGCATT -> CGATCGCATTT
CCGATCTAAGC -> CGATCTAAGCC
CCGATGTCGTG -> CGATGTCGTGT
CCGATTCCTCC -> CGATTCCTCCA
CCGATTGGCGG -> CGATTGGCGGA
CCGCAGACGAA -> CGCAGACGAAG
CCGCGAATGTC -> CGCGAATGTCG
CCGCTATCGAA -> CGCTATCGAAC
CCGGAAAGGGG -> CGGAAAGGGGC
CCGGAGAGAAG -> CGGAGAGAAGG
CCGGAGTACGC -> CGGAGTACGCG
CCGGATGGTCG -> CGGATGGTCGT
CCGGCGGTCCG -> CGGCGGTCCGG
CCGGGTCTCAT -> CGGGTCTCATG
CCGGTACACGT -> CGGTACACGTT
CCGGTTATCGA -> CGGTTATCGAG
CCGTAGACTTC -> CGTAGACTTCG
CCGTAGGGGAT -> CGTAGGGGATC
CCGTCAGCTGG -> CGTCAGCTGGC
CCGTCGCAGCA -> CGTCGCAGCAG
CCGTCGCTCGG -> CGTCGCTCGGT
CCGTCTTCATC -> CGTCTTCATCT
CCGTGCGTCGG -> CGTGCGTCGGA
CCGTGCTCGGT -> CGTGCTCGGTT
CCGTGTGCAAC -> CGTGTGCAACT
CCTACACACTA -> CTACACACTAC
CCTACCTCAAT -> CTACCTCAATT
CCTACGTTCTC -> CTACGTTCTCA
CCTACTGCACG -> CTACTGCACGT
CCTAGTCTTTC -> CTAGTCTTTCC
CCTATCCGTCA -> CTATCCGTCAG
CCTATGAGAGA -> CTATGAGAGAT
CCTATTAACCG -> CTATTAACCGG
CCTCAAGAACC -> CTCAAGAACCA
CCTCAATTTGG -> CTCAATTTGGA
CCTCCAGCGCG -> CTCCAGCGCGC
CCTCCCATCTG -> CTCCCATCTGG
CCTCCGATTGG -> CTCCGATTGGC
CCTCCTATCCG -> CTCCTATCCGT
CCTCGTCCTGC -> CTCGTCCTGCC
CCTCTAAACCG -> CTCTAAACCGT
CCTCTACAGTA -> CTCTACAGTAA
CCTGAAAGTCT -> CTGAAAGTCTC
CCTGAAGTTTG -> CTGAAGTTTGT
CCTGCCTACGT -> CTGCCTACGTT
CCTGTCTGCAC -> CTGTCTGCACC
CCTTCATTGTG -> CTTCATTGTGA
CCTTCCAAGCC -> CTTCCAAGCCT
CCTTGTATGCC -> CTTGTATGCCC
CCTTGTTCTTA -> CTTGTTCTTAT
CCTTTGTTTAC -> CTTTGTTTACG
CGAACAAGGGG -> GAACAAGGGGG
CGAACCGATCT -> GAACCGATCTA
CGAACGCGCTC -> GAACGCGCTCT
CGAACTATGAC -> GAACTATGACC
CGAAGCCAATA -> GAAGCCAATAA
CGAAGGGAAGG -> GAAGGGAAGGG
CGAAGGTGATG -> GAAGGTGATGC
CGAAGTAGATA -> GAAGTAGATAA
CGAATCGGTGC -> GAATCGGTGCA
CGAATGTCGTC -> GAATGTCGTCG
CGACAGCTCAA -> GACAGCTCAAC
CGACCAGAGTC -> GACCAGAGTCT
CGACCATCACC -> GACCATCACCC
CGACCATCTGC -> GACCATCTGCT
CGACCGGCGGT -> GACCGGCGGTC
CGACGAGTACC -> GACGAGTACCC
CGACGCGTCGC -> GACGCGTCGCT
CGACTAGGAAG -> GACTAGGAAGC
CGAGAACTCAA -> GAGAACTCAAG
CGAGGAAAATC -> GAGGAAAATCC
CGAGGGCTTTC -> GAGGGCTTTCG
CGAGGGGCTAC -> GAGGGGCTACA
CGAGTACCCTA -> GAGTACCCTAC
CGAGTAGCACG -> GAGTAGCACGG
CGAGTCCAATT -> GAGTCCAATTA
CGAGTTGCGTC -> GAGTTGCGTCA
CGATAAACCCT -> GATAAACCCTA
CGATAGTATTA -> GATAGTATTAG
CGATCGCATTT -> GATCGCATTTG
CGATCTAAGCC -> GATCTAAGCCA
CGATCTTCATG -> GATCTTCATGT
CGATGTCGTGT -> GATGTCGTGTT
CGATGTTTTAT -> GATGTTTTATT
CGATTCATGTG -> GATTCATGTGA
CGATTCCTCCA -> GATTCCTCCAG
CGATTGGCGGA -> GATTGGCGGAA
CGCAAAATACC -> GCAAAATACCG
CGCAAAGAAAG -> GCAAAGAAAGG
CGCAATCTCGA -> GCAATCTCGAT
CGCAATGCCGG -> GCAATGCCGGA
CGCACCACGGT -> GCACCACGGTT
CGCACCCGATG -> GCACCCGATGT
CGCAGACGAAG -> GCAGACGAAGG
CGCAGCAGCTC -> GCAGCAGCTCT
CGCAGTCCTCA -> GCAGTCCTCAA
CGCAGTTAGCC -> GCAGTTAGCCA
CGCATTTGACG -> GCATTTGACGA
CGCCAAAGGTT -> GCCAAAGGTTT
CGCCCCTCCGA -> GCCCCTCCGAT
CGCCCGAAGTA -> GCCCGAAGTAG
CGCCCGCTATC -> GCCCGCTATCG
CGCCCTTCCAA -> GCCCTTCCAAG
CGCCGGTACAC -> GCCGGTACACG
CGCGAAGCCAA -> GCGAAGCCAAT
CGCGAATGTCG -> GCGAATGTCGT
CGCGACGCGTC -> GCGACGCGTCG
CGCGCGGAGGA -> GCGCGGAGGAG
CGCGCGGTCGA -> GCGCGGTCGAC
CGCGCTCTTTG -> GCGCTCTTTGG
CGCGCTTTGTC -> GCGCTTTGTCC
CGCGGAGGAGT -> GCGGAGGAGTG
CGCGGGGCCGT -> GCGGGGCCGTC
CGCGGTCGACC -> GCGGTCGACCG
CGCGTCCCAAT -> GCGTCCCAATA
CGCGTCGCTAT -> GCGTCGCTATT
CGCGTTACGCA -> GCGTTACGCAA
CGCTATCGAAC -> GCTATCGAACC
CGCTATGCTCC -> GCTATGCTCCT
CGCTATTTACC -> GCTATTTACCT
CGCTCACATAC -> GCTCACATACG
CGCTCACGAGG -> GCTCACGAGGG
CGCTCGGTAAA -> GCTCGGTAAAC
CGCTCTTTGGT -> GCTCTTTGGTG
CGCTTAATTCC -> GCTTAATTCCG
CGCTTTGTCCA -> GCTTTGTCCAC
CGCTTTTATGA -> GCTTTTATGAT
CGGAAAGGGGC -> GGAAAGGGGCT
CGGAAATCGTC -> GGAAATCGTCG
CGGACTGCAAC -> GGACTGCAACA
CGGAGAGAAGG -> GGAGAGAAGGT
CGGAGCAGTAG -> GGAGCAGTAGT
CGGAGGAGAGC -> GGAGGAGAGCG
CGGAGGAGTGT -> GGAGGAGTGTC
CGGAGTACGCG -> GGAGTACGCGC
CGGATCAGCTA -> GGATCAGCTAG
CGGATGGTCGT -> GGATGGTCGTG
CGGCACTGCCA -> GGCACTGCCAG
CGGCAGAGCCG -> GGCAGAGCCGT
CGGCAGCACCG -> GGCAGCACCGA
CGGCGATTCAT -> GGCGATTCATG
CGGCGGTCCGG -> GGCGGTCCGGG
CGGCTACCCCC -> GGCTACCCCCA
CGGCTAGACTA -> GGCTAGACTAG
CGGCTATTAGG -> GGCTATTAGGA
CGGCTGCGCAA -> GGCTGCGCAAT
CGGGGCCGTCG -> GGGGCCGTCGC
CGGGTACTAAT -> GGGTACTAATC
CGGGTCTCATG -> GGGTCTCATGA
CGGGTTGAAGG -> GGGTTGAAGGA
CGGTAAACAGG -> GGTAAACAGGG
CGGTACACGTT -> GGTACACGTTC
CGGTCCGGGTC -> GGTCCGGGTCT
CGGTCGACCGG -> GGTCGACCGGC
CGGTGCAGACT -> GGTGCAGACTG
CGGTTATCGAG -> GGTTATCGAGG
CGGTTGCAAGC -> GGTTGCAAGCA
CGGTTGCGAAC -> GGTTGCGAACG
CGGTTTGATAG -> GGTTTGATAGG
CGTAGACTTCG -> GTAGACTTCGC
CGTAGGGGATC -> GTAGGGGATCG
CGTCACAGTGA -> GTCACAGTGAC
CGTCAGCTGGC -> GTCAGCTGGCT
CGTCATTGGAT -> GTCATTGGATC
CGTCCACTAGC -> GTCCACTAGCG
CGTCCCAATAA -> GTCCCAATAAA
CGTCCTGCCTA -> GTCCTGCCTAC
CGTCGCAGCAG -> GTCGCAGCAGC
CGTCGCTATGC -> GTCGCTATGCT
CGTCGCTATTT -> GTCGCTATTTA
CGTCGCTCGGT -> GTCGCTCGGTA
CGTCGGAGGAG -> GTCGGAGGAGA
CGTCGGCTACC -> GTCGGCTACCC
CGTCTTCATCT -> GTCTTCATCTG
CGTCTTGGTAA -> GTCTTGGTAAG
CGTGACACAAC -> GTGACACAACC
CGTGCGTCGGA -> GTGCGTCGGAG
CGTGCTCGGTT -> GTGCTCGGTTG
CGTGGCGCACC -> GTGGCGCACCC
CGTGGCTTTTT -> GTGGCTTTTTG
CGTGTGCAACT -> GTGTGCAACTA
CGTGTTCGATC -> GTGTTCGATCT
CGTTACGCAAA -> GTTACGCAAAA
CGTTATCTCCA -> GTTATCTCCAG
CGTTCGCGAAG -> GTTCGCGAAGC
CGTTCTCATTG -> GTTCTCATTGA
CTAAACCGTCG -> TAAACCGTCGC
CTAAATCCGGT -> TAAATCCGGTT
CTAACAAGTAA -> TAACAAGTAAC
CTAAGCCAAAG -> TAAGCCAAAGC
CTAAGGCGACC -> TAAGGCGACCA
CTAATCCGATT -> TAATCCGATTC
CTACACACTAC -> TACACACTACA
CTACACGCACC -> TACACGCACCA
CTACAGTAACT -> TACAGTAACTA
CTACATTACTG -> TACATTACTGC
CTACCACTGGC -> TACCACTGGCC
CTACCCCCATT -> TACCCCCATTC
CTACCCCTATG -> TACCCCTATGA
CTACCGTGCTC -> TACCGTGCTCG
CTACCTCAATT -> TACCTCAATTT
CTACGCGGGGC -> TACGCGGGGCC
CTACGGCAGAG -> TACGGCAGAGC
CTACGTTCTCA -> TACGTTCTCAT
CTACTCTACGG -> TACTCTACGGC
CTACTGCACGT -> TACTGCACGTC
CTAGAATACAA -> TAGAATACAAA
CTAGACTAGGA -> TAGACTAGGAC
CTAGAGAGGCA -> TAGAGAGGCAA
CTAGCGCGCTT -> TAGCGCGCTTT
CTAGGAAGCTT -> TAGGAAGCTTA
CTAGGACGAAC -> TAGGACGAACA
CTAGGCGGCTA -> TAGGCGGCTAG
CTAGTCTTTCC -> TAGTCTTTCCT
CTATCCGTCAG -> TATCCGTCAGC
CTATCGAACCG -> TATCGAACCGA
CTATGACCAAA -> TATGACCAAAG
CTATGAGAGAT -> TATGAGAGATG
CTATGCTCCTC -> TATGCTCCTCG
CTATTAACCGG -> TATTAACCGGA
CTATTAGGATC -> TATTAGGATCA
CTATTCGCCCC -> TATTCGCCCCT
CTATTCTGGTG -> TATTCTGGTGC
CTATTTACCTC -> TATTTACCTCC
CTATTTTAGGT -> TATTTTAGGTT
CTCAACAATCA -> TCAACAATCAC
CTCAAGAACCA -> TCAAGAACCAT
CTCAAGCGTCT -> TCAAGCGTCTT
CTCAATTTGGA -> TCAATTTGGAG
CTCACATACGG -> TCACATACGGA
CTCACGAGGGC -> TCACGAGGGCT
CTCAGGCCCAT -> TCAGGCCCATA
CTCATGAGCAC -> TCATGAGCACT
CTCATTGATGC -> TCATTGATGCA
CTCCAGCGCGC -> TCCAGCGCGCG
CTCCAGTCAGC -> TCCAGTCAGCT
CTCCCATCCGC -> TCCCATCCGCA
CTCCCATCTGG -> TCCCATCTGGC
CTCCGATTGGC -> TCCGATTGGCG
CTCCTATCCGT -> TCCTATCCGTC
CTCCTATTAAC -> TCCTATTAACC
CTCCTCGTCCT -> TCCTCGTCCTG
CTCCTTGTTCT -> TCCTTGTTCTT
CTCGACCATCA -> TCGACCATCAC
CTCGATGTTTT -> TCGATGTTTTA
CTCGCTTAATT -> TCGCTTAATTC
CTCGGTAAACA -> TCGGTAAACAG
CTCGGTTGCAA -> TCGGTTGCAAG
CTCGTCCTGCC -> TCGTCCTGCCT
CTCGTGGCTTT -> TCGTGGCTTTT
CTCTAAACCGT -> TCTAAACCGTC
CTCTACAGTAA -> TCTACAGTAAC
CTCTACGCGGG -> TCTACGCGGGG
CTCTACGGCAG -> TCTACGGCAGA
CTCTCTTAGAA -> TCTCTTAGAAG
CTCTTAGAAGT -> TCTTAGAAGTT
CTCTTCTAGGC -> TCTTCTAGGCG
CTCTTTGGTGT -> TCTTTGGTGTA
CTGAAAGTCTC -> TGAAAGTCTCA
CTGAACCATGA -> TGAACCATGAG
CTGAAGTTTGT -> TGAAGTTTGTA
CTGACAAGTGG -> TGACAAGTGGG
CTGCAACACGG -> TGCAACACGGT
CTGCACCCGTG -> TGCACCCGTGC
CTGCACGTCCA -> TGCACGTCCAC
CTGCAGTTGGC -> TGCAGTTGGCA
CTGCCACCCGA -> TGCCACCCGAC
CTGCCAGATTT -> TGCCAGATTTT
CTGCCTACGTT -> TGCCTACGTTC
CTGCCTTTGTT -> TGCCTTTGTTT
CTGCGCAATGC -> TGCGCAATGCC
CTGCGCTCACG -> TGCGCTCACGA
CTGCTACCGTG -> TGCTACCGTGC
CTGGAGAGGGA -> TGGAGAGGGAC
CTGGCAAGTCC -> TGGCAAGTCCA
CTGGCCTGAAA -> TGGCCTGAAAG
CTGGCTAAGGC -> TGGCTAAGGCG
CTGGCTTCCAT -> TGGCTTCCATC
CTGGCTTCCCC -> TGGCTTCCCCC
CTGGTGCCACA -> TGGTGCCACAC
CTGTACACATC -> TGTACACATCG
CTGTATGCGGG -> TGTATGCGGGT
CTGTCTGCACC -> TGTCTGCACCC
CTTAATTCCGA -> TTAATTCCGAC
CTTAGAAGTTG -> TTAGAAGTTGC
CTTAGAGTCGC -> TTAGAGTCGCA
CTTATCAAAAT -> TTATCAAAATC
CTTCATCTGAC -> TTCATCTGACA
CTTCATGTTCT -> TTCATGTTCTA
CTTCATTGTGA -> TTCATTGTGAT
CTTCCAAGCCT -> TTCCAAGCCTG
CTTCCATCGCG -> TTCCATCGCGT
CTTCCCCCGGA -> TTCCCCCGGAG
CTTCGCGTTAC -> TTCGCGTTACG
CTTCTAGGCGG -> TTCTAGGCGGC
CTTCTGCGCTC -> TTCTGCGCTCA
CTTGCATCACG -> TTGCATCACGG
CTTGGTAAGGT -> TTGGTAAGGTT
CTTGTATGCCC -> TTGTATGCCCA
CTTGTTCTTAT -> TTGTTCTTATC
CTTTATGTAAG -> TTTATGTAAGT
CTTTCCTACAC -> TTTCCTACACA
CTTTCGAGAAC -> TTTCGAGAACT
CTTTGGTGTAT -> TTTGGTGTATC
CTTTGTCCACC -> TTTGTCCACCG
CTTTGTTTACG -> TTTGTTTACGA
CTTTTATGATG -> TTTTATGATGA
CTTTTTCAGTG -> TTTTTCAGTGG
CTTTTTGAGCC -> TTTTTGAGCCG
GAAAATCCTCT -> AAAATCCTCTA
GAAAGGGGCTC -> AAAGGGGCTCC
GAAAGGTGGTA -> AAAGGTGGTAC
GAAAGTCTCAG -> AAAGTCTCAGG
GAAATCGTCGC -> AAATCGTCGCT
GAACAAGGGGG -> AACAAGGGGGA
GAACCATAACT -> AACCATAACTG
GAACCATGAGT -> AACCATGAGTC
GAACCGATCTA -> AACCGATCTAA
GAACGCGCTCT -> AACGCGCTCTT
GAACTATGACC -> AACTATGACCA
GAACTCAAGCG -> AACTCAAGCGT
GAACTGCAGTT -> AACTGCAGTTG
GAAGCCAATAA -> AAGCCAATAAA
GAAGCTTAGAG -> AAGCTTAGAGT
GAAGGAGCGGA -> AAGGAGCGGAT
GAAGGGAAGGG -> AAGGGAAGGGT
GAAGGGCTCTT -> AAGGGCTCTTC
GAAGGGTAAAG -> AAGGGTAAAGC
GAAGGTGATGC -> AAGGTGATGCA
GAAGGTGCATT -> AAGGTGCATTC
GAAGTAGATAA -> AAGTAGATAAT
GAAGTTGCTCG -> AAGTTGCTCGT
GAAGTTTGTAA -> AAGTTTGTAAC
GAATACAAAGG -> AATACAAAGGC
GAATCGGTGCA -> AATCGGTGCAG
GAATGTCGTCG -> AATGTCGTCGG
GACAAAACACA -> ACAAAACACAC
GACAAGTGGGC -> ACAAGTGGGCT
GACACAACCTT -> ACACAACCTTG
GACAGCTCAAC -> ACAGCTCAACA
GACCAAAGAGT -> ACCAAAGAGTA
GACCACACGCG -> ACCACACGCGA
GACCAGAGTCT -> ACCAGAGTCTG
GACCATCACCC -> ACCATCACCCG
GACCATCTGCT -> ACCATCTGCTA
GACCGGCGGTC -> ACCGGCGGTCC
GACGAACAAGG -> ACGAACAAGGG
GACGAACTATG -> ACGAACTATGA
GACGAAGGGAA -> ACGAAGGGAAG
GACGACCAGAG -> ACGACCAGAGT
GACGAGTACCC -> ACGAGTACCCT
GACGATAGTAT -> ACGATAGTATT
GACGCAAAGAA -> ACGCAAAGAAA
GACGCCCTTCC -> ACGCCCTTCCA
GACGCCGGTAC -> ACGCCGGTACA
GACGCGTCGCT -> ACGCGTCGCTA
GACTAGGAAGC -> ACTAGGAAGCT
GACTAGGACGA -> ACTAGGACGAA
GACTCGACCAT -> ACTCGACCATC
GACTGCAACAC -> ACTGCAACACG
GACTGTATGCG -> ACTGTATGCGG
GACTTCGCGTT -> ACTTCGCGTTA
GAGAACTCAAG -> AGAACTCAAGC
GAGAAGGGCTC -> AGAAGGGCTCT
GAGAAGGTGCA -> AGAAGGTGCAT
GAGACGAACTA -> AGACGAACTAT
GAGACGCCCTT -> AGACGCCCTTC
GAGAGAAGGGC -> AGAGAAGGGCT
GAGAGAAGGTG -> AGAGAAGGTGC
GAGAGATGTCT -> AGAGATGTCTA
GAGAGCGCTTT -> AGAGCGCTTTT
GAGAGGCAAAC -> AGAGGCAAACC
GAGAGGGACCA -> AGAGGGACCAC
GAGATGTCTAT -> AGATGTCTATT
GAGCACTTCTG -> AGCACTTCTGC
GAGCAGTAGTT -> AGCAGTAGTTC
GAGCCGAATCG -> AGCCGAATCGG
GAGCCGTAGAC -> AGCCGTAGACT
GAGCGCAGTTA -> AGCGCAGTTAG
GAGCGCTTTTA -> AGCGCTTTTAT
GAGCGGATCAG -> AGCGGATCAGC
GAGCTAACAAG -> AGCTAACAAGT
GAGGAAAATCC -> AGGAAAATCCT
GAGGAGAGCGC -> AGGAGAGCGCT
GAGGAGTGTCT -> AGGAGTGTCTG
GAGGCAAACCA -> AGGCAAACCAG
GAGGCAGGCGT -> AGGCAGGCGTG
GAGGCGCAGTC -> AGGCGCAGTCC
GAGGGACCACA -> AGGGACCACAC
GAGGGCTTTCG -> AGGGCTTTCGA
GAGGGGCTACA -> AGGGGCTACAC
GAGTACCCTAC -> AGTACCCTACC
GAGTACGCGCG -> AGTACGCGCGG
GAGTAGCACGG -> AGTAGCACGGC
GAGTATCTACT -> AGTATCTACTC
GAGTCCAACCT -> AGTCCAACCTC
GAGTCCAATTA -> AGTCCAATTAT
GAGTCGCAATC -> AGTCGCAATCT
GAGTCTGGCAA -> AGTCTGGCAAG
GAGTGTCTGTA -> AGTGTCTGTAC
GAGTTGCGTCA -> AGTTGCGTCAC
GATAAACCCTA -> ATAAACCCTAG
GATAATATCAT -> ATAATATCATG
GATAGCACGCC -> ATAGCACGCCC
GATAGGCCACC -> ATAGGCCACCA
GATAGTATTAG -> ATAGTATTAGT
GATCAGCTAGA -> ATCAGCTAGAG
GATCAGTTCGG -> ATCAGTTCGGC
GATCATCTTTT -> ATCATCTTTTT
GATCGCATTTG -> ATCGCATTTGA
GATCGGCGATT -> ATCGGCGATTC
GATCTAAGCCA -> ATCTAAGCCAA
GATCTGGAGAG -> ATCTGGAGAGG
GATCTTCATGT -> ATCTTCATGTT
GATGAACTGCA -> ATGAACTGCAG
GATGAGAGAAG -> ATGAGAGAAGG
GATGCAGGTGG -> ATGCAGGTGGT
GATGCATCACG -> ATGCATCACGT
GATGGTCGTGA -> ATGGTCGTGAC
GATGTCGTGTT -> ATGTCGTGTTC
GATGTCTATTC -> ATGTCTATTCG
GATGTTTTATT -> ATGTTTTATTT
GATTCATGTGA -> ATTCATGTGAC
GATTCCTCCAG -> ATTCCTCCAGC
GATTCGATAAA -> ATTCGATAAAC
GATTGGCGGAA -> ATTGGCGGAAA
GATTTTGGGAC -> ATTTTGGGACG
GATTTTGGGCG -> ATTTTGGGCGG
GCAAAATACCG -> CAAAATACCGT
GCAAACCAGCA -> CAAACCAGCAG
GCAAAGAAAGG -> CAAAGAAAGGT
GCAACACGGTT -> CAACACGGTTT
GCAACTATTTT -> CAACTATTTTA
GCAAGCAGCTC -> CAAGCAGCTCC
GCAAGTCCAAC -> CAAGTCCAACT
GCAATCTCGAT -> CAATCTCGATG
GCAATGCCGGA -> CAATGCCGGAG
GCACCACGGTT -> CACCACGGTTG
GCACCCGATGT -> CACCCGATGTC
GCACCCGTGCG -> CACCCGTGCGT
GCACCGAGTTG -> CACCGAGTTGC
GCACGAAGGTG -> CACGAAGGTGA
GCACGCCCGCT -> CACGCCCGCTA
GCACGGCTATT -> CACGGCTATTA
GCACGTCCACT -> CACGTCCACTA
GCACTGCCAGA -> CACTGCCAGAT
GCACTTCTGCG -> CACTTCTGCGC
GCAGACGAAGG -> CAGACGAAGGG
GCAGACTGTAT -> CAGACTGTATG
GCAGAGCCGTA -> CAGAGCCGTAG
GCAGAGCGCAG -> CAGAGCGCAGT
GCAGATGAACT -> CAGATGAACTG
GCAGCACCGAG -> CAGCACCGAGT
GCAGCAGCTCT -> CAGCAGCTCTC
GCAGCGCCCGA -> CAGCGCCCGAA
GCAGCTCCCAT -> CAGCTCCCATC
GCAGCTCTCTT -> CAGCTCTCTTA
GCAGGCGTGGC -> CAGGCGTGGCG
GCAGGTGGTAG -> CAGGTGGTAGA
GCAGTAGTTCC -> CAGTAGTTCCC
GCAGTCCTCAA -> CAGTCCTCAAG
GCAGTTAGCCA -> CAGTTAGCCAG
GCAGTTGGCAT -> CAGTTGGCATT
GCATCACGGGT -> CATCACGGGTA
GCATCACGTCA -> CATCACGTCAT
GCATTATTCCT -> CATTATTCCTC
GCATTCCTGTC -> CATTCCTGTCT
GCATTTCACGC -> CATTTCACGCT
GCATTTGACGA -> CATTTGACGAC
GCCAAAGCCGG -> CCAAAGCCGGA
GCCAAAGGTTT -> CCAAAGGTTTT
GCCAATAAAAA -> CCAATAAAAAG
GCCACACTCCT -> CCACACTCCTA
GCCACCAGACT -> CCACCAGACTC
GCCACCCGACA -> CCACCCGACAG
GCCAGATTTTG -> CCAGATTTTGG
GCCAGCTTGCA -> CCAGCTTGCAT
GCCATTGCAGA -> CCATTGCAGAT
GCCCAAAACGC -> CCCAAAACGCC
GCCCCTCCGAT -> CCCCTCCGATT
GCCCGAAGTAG -> CCCGAAGTAGA
GCCCGCTATCG -> CCCGCTATCGA
GCCCTTCCAAG -> CCCTTCCAAGC
GCCGAATCGGT -> CCGAATCGGTG
GCCGGAAAGGG -> CCGGAAAGGGG
GCCGGAGTACG -> CCGGAGTACGC
GCCGGTACACG -> CCGGTACACGT
GCCGTAGACTT -> CCGTAGACTTC
GCCGTCGCAGC -> CCGTCGCAGCA
GCCTACGTTCT -> CCTACGTTCTC
GCCTGAAAGTC -> CCTGAAAGTCT
GCCTGAAGTTT -> CCTGAAGTTTG
GCCTTTGTTTA -> CCTTTGTTTAC
GCGAACGCGCT -> CGAACGCGCTC
GCGAAGCCAAT -> CGAAGCCAATA
GCGAATGTCGT -> CGAATGTCGTC
GCGACCATCTG -> CGACCATCTGC
GCGACGCGTCG -> CGACGCGTCGC
GCGAGTAGCAC -> CGAGTAGCACG
GCGATTCATGT -> CGATTCATGTG
GCGCAATGCCG -> CGCAATGCCGG
GCGCACCCGAT -> CGCACCCGATG
GCGCAGTCCTC -> CGCAGTCCTCA
GCGCAGTTAGC -> CGCAGTTAGCC
GCGCCCGAAGT -> CGCCCGAAGTA
GCGCGCGGTCG -> CGCGCGGTCGA
GCGCGCTTTGT -> CGCGCTTTGTC
GCGCGGAGGAG -> CGCGGAGGAGT
GCGCGGTCGAC -> CGCGGTCGACC
GCGCTCACGAG -> CGCTCACGAGG
GCGCTCTTTGG -> CGCTCTTTGGT
GCGCTTTGTCC -> CGCTTTGTCCA
GCGCTTTTATG -> CGCTTTTATGA
GCGGAAATCGT -> CGGAAATCGTC
GCGGACTGCAA -> CGGACTGCAAC
GCGGAGGAGTG -> CGGAGGAGTGT
GCGGATCAGCT -> CGGATCAGCTA
GCGGCTAGACT -> CGGCTAGACTA
GCGGCTGCGCA -> CGGCTGCGCAA
GCGGGGCCGTC -> CGGGGCCGTCG
GCGGGTTGAAG -> CGGGTTGAAGG
GCGGTCCGGGT -> CGGTCCGGGTC
GCGGTCGACCG -> CGGTCGACCGG
GCGTCACAGTG -> CGTCACAGTGA
GCGTCCCAATA -> CGTCCCAATAA
GCGTCGCTATT -> CGTCGCTATTT
GCGTCGGAGGA -> CGTCGGAGGAG
GCGTCTTGGTA -> CGTCTTGGTAA
GCGTGGCGCAC -> CGTGGCGCACC
GCGTTACGCAA -> CGTTACGCAAA
GCTAACAAGTA -> CTAACAAGTAA
GCTAAGGCGAC -> CTAAGGCGACC
GCTACACGCAC -> CTACACGCACC
GCTACCACTGG -> CTACCACTGGC
GCTACCCCCAT -> CTACCCCCATT
GCTACCGTGCT -> CTACCGTGCTC
GCTAGAATACA -> CTAGAATACAA
GCTAGACTAGG -> CTAGACTAGGA
GCTAGAGAGGC -> CTAGAGAGGCA
GCTATCGAACC -> CTATCGAACCG
GCTATGCTCCT -> CTATGCTCCTC
GCTATTAGGAT -> CTATTAGGATC
GCTATTTACCT -> CTATTTACCTC
GCTCAACAATC -> CTCAACAATCA
GCTCACATACG -> CTCACATACGG
GCTCACGAGGG -> CTCACGAGGGC
GCTCCCATCCG -> CTCCCATCCGC
GCTCCTCGTCC -> CTCCTCGTCCT
GCTCCTTGTTC -> CTCCTTGTTCT
GCTCGGTAAAC -> CTCGGTAAACA
GCTCGGTTGCA -> CTCGGTTGCAA
GCTCGTGGCTT -> CTCGTGGCTTT
GCTCTCTTAGA -> CTCTCTTAGAA
GCTCTTCTAGG -> CTCTTCTAGGC
GCTCTTTGGTG -> CTCTTTGGTGT
GCTGCGCAATG -> CTGCGCAATGC
GCTGGCTTCCA -> CTGGCTTCCAT
GCTTAATTCCG -> CTTAATTCCGA
GCTTAGAGTCG -> CTTAGAGTCGC
GCTTCCATCGC -> CTTCCATCGCG
GCTTCCCCCGG -> CTTCCCCCGGA
GCTTGCATCAC -> CTTGCATCACG
GCTTTATGTAA -> CTTTATGTAAG
GCTTTCGAGAA -> CTTTCGAGAAC
GCTTTGTCCAC -> CTTTGTCCACC
GCTTTTATGAT -> CTTTTATGATG
GCTTTTTGAGC -> CTTTTTGAGCC
GGAAAATCCTC -> GAAAATCCTCT
GGAAAGGGGCT -> GAAAGGGGCTC
GGAAATCGTCG -> GAAATCGTCGC
GGAAGCTTAGA -> GAAGCTTAGAG
GGAAGGGTAAA -> GAAGGGTAAAG
GGACCACACGC -> GACCACACGCG
GGACGAACAAG -> GACGAACAAGG
GGACGCCGGTA -> GACGCCGGTAC
GGACTGCAACA -> GACTGCAACAC
GGAGACGCCCT -> GAGACGCCCTT
GGAGAGAAGGT -> GAGAGAAGGTG
GGAGAGCGCTT -> GAGAGCGCTTT
GGAGAGGGACC -> GAGAGGGACCA
GGAGCAGTAGT -> GAGCAGTAGTT
GGAGCGGATCA -> GAGCGGATCAG
GGAGCTAACAA -> GAGCTAACAAG
GGAGGAGAGCG -> GAGGAGAGCGC
GGAGGAGTGTC -> GAGGAGTGTCT
GGAGGCAGGCG -> GAGGCAGGCGT
GGAGTACGCGC -> GAGTACGCGCG
GGAGTGTCTGT -> GAGTGTCTGTA
GGATCAGCTAG -> GATCAGCTAGA
GGATCAGTTCG -> GATCAGTTCGG
GGATCGGCGAT -> GATCGGCGATT
GGATCTGGAGA -> GATCTGGAGAG
GGATGGTCGTG -> GATGGTCGTGA
GGCAAACCAGC -> GCAAACCAGCA
GGCAAGTCCAA -> GCAAGTCCAAC
GGCACTGCCAG -> GCACTGCCAGA
GGCAGAGCCGT -> GCAGAGCCGTA
GGCAGCACCGA -> GCAGCACCGAG
GGCAGCGCCCG -> GCAGCGCCCGA
GGCAGGCGTGG -> GCAGGCGTGGC
GGCATTATTCC -> GCATTATTCCT
GGCATTTCACG -> GCATTTCACGC
GGCCACCAGAC -> GCCACCAGACT
GGCCGTCGCAG -> GCCGTCGCAGC
GGCCTGAAAGT -> GCCTGAAAGTC
GGCGACCATCT -> GCGACCATCTG
GGCGATTCATG -> GCGATTCATGT
GGCGCACCCGA -> GCGCACCCGAT
GGCGCAGTCCT -> GCGCAGTCCTC
GGCGGAAATCG -> GCGGAAATCGT
GGCGGACTGCA -> GCGGACTGCAA
GGCGGCTAGAC -> GCGGCTAGACT
GGCGGTCCGGG -> GCGGTCCGGGT
GGCGTGGCGCA -> GCGTGGCGCAC
GGCTAAGGCGA -> GCTAAGGCGAC
GGCTACACGCA -> GCTACACGCAC
GGCTACCACTG -> GCTACCACTGG
GGCTACCCCCA -> GCTACCCCCAT
GGCTAGACTAG -> GCTAGACTAGG
GGCTATTAGGA -> GCTATTAGGAT
GGCTCCTTGTT -> GCTCCTTGTTC
GGCTCTTCTAG -> GCTCTTCTAGG
GGCTGCGCAAT -> GCTGCGCAATG
GGCTTCCATCG -> GCTTCCATCGC
GGCTTCCCCCG -> GCTTCCCCCGG
GGCTTTCGAGA -> GCTTTCGAGAA
GGCTTTTTGAG -> GCTTTTTGAGC
GGGAAGGGTAA -> GGAAGGGTAAA
GGGACCACACG -> GGACCACACGC
GGGACGCCGGT -> GGACGCCGGTA
GGGAGCTAACA -> GGAGCTAACAA
GGGATCGGCGA -> GGATCGGCGAT
GGGCCGTCGCA -> GGCCGTCGCAG
GGGCGGACTGC -> GGCGGACTGCA
GGGCTACACGC -> GGCTACACGCA
GGGCTACCACT -> GGCTACCACTG
GGGCTCCTTGT -> GGCTCCTTGTT
GGGCTCTTCTA -> GGCTCTTCTAG
GGGCTTTCGAG -> GGCTTTCGAGA
GGGGAGCTAAC -> GGGAGCTAACA
GGGGATCGGCG -> GGGATCGGCGA
GGGGCCGTCGC -> GGGCCGTCGCA
GGGGCTACACG -> GGGCTACACGC
GGGGCTCCTTG -> GGGCTCCTTGT
GGGGGAGCTAA -> GGGGAGCTAAC
GGGGGTACAGT -> GGGGTACAGTC
GGGGTACAGTC -> GGGTACAGTCA
GGGTAAAGCGG -> GGTAAAGCGGC
GGGTACAGTCA -> GGTACAGTCAG
GGGTACTAATC -> GGTACTAATCC
GGGTCCGTAGG -> GGTCCGTAGGG
GGGTCTCATGA -> GGTCTCATGAG
GGGTTGAAGGA -> GGTTGAAGGAG
GGTAAACAGGG -> GTAAACAGGGG
GGTAAAGCGGC -> GTAAAGCGGCT
GGTAAGGTTGA -> GTAAGGTTGAG
GGTACACGTTC -> GTACACGTTCG
GGTACAGTCAG -> GTACAGTCAGC
GGTACTAATCC -> GTACTAATCCG
GGTACTCTACG -> GTACTCTACGC
GGTAGAGACGA -> GTAGAGACGAA
GGTCCGGGTCT -> GTCCGGGTCTC
GGTCCGTAGGG -> GTCCGTAGGGG
GGTCGACCGGC -> GTCGACCGGCG
GGTCGTGACAC -> GTCGTGACACA
GGTCTCATGAG -> GTCTCATGAGC
GGTGATGCAGG -> GTGATGCAGGT
GGTGCACGAAG -> GTGCACGAAGG
GGTGCAGACTG -> GTGCAGACTGT
GGTGCATTCCT -> GTGCATTCCTG
GGTGCCACACT -> GTGCCACACTC
GGTGGTACTCT -> GTGGTACTCTA
GGTGGTAGAGA -> GTGGTAGAGAC
GGTGTATCGAG -> GTGTATCGAGG
GGTTATCACCT -> GTTATCACCTT
GGTTATCGAGG -> GTTATCGAGGG
GGTTGAAGGAG -> GTTGAAGGAGC
GGTTGAGGCGC -> GTTGAGGCGCA
GGTTGCAAGCA -> GTTGCAAGCAG
GGTTGCGAACG -> GTTGCGAACGC
GGTTTGATAGG -> GTTTGATAGGC
GGTTTTTTCTG -> GTTTTTTCTGA
GTAAACAGGGG -> TAAACAGGGGG
GTAAAGCGGCT -> TAAAGCGGCTG
GTAACGGCACT -> TAACGGCACTG
GTAACTAAATC -> TAACTAAATCC
GTAACTACCCC -> TAACTACCCCT
GTAAGGTTGAG -> TAAGGTTGAGG
GTAAGTTTGGA -> TAAGTTTGGAG
GTACACATCGA -> TACACATCGAG
GTACACGTTCG -> TACACGTTCGC
GTACAGTCAGC -> TACAGTCAGCC
GTACCCTACCT -> TACCCTACCTC
GTACGCGCGGA -> TACGCGCGGAG
GTACTAATCCG -> TACTAATCCGA
GTACTCTACGC -> TACTCTACGCG
GTAGACTTCGC -> TAGACTTCGCG
GTAGAGACGAA -> TAGAGACGAAC
GTAGATAATAT -> TAGATAATATC
GTAGCACGGCT -> TAGCACGGCTA
GTAGGGGATCG -> TAGGGGATCGG
GTAGTTCCCGA -> TAGTTCCCGAT
GTATCGAGGAA -> TATCGAGGAAA
GTATCTACTCT -> TATCTACTCTA
GTATGCCCAAA -> TATGCCCAAAA
GTATGCGGGTT -> TATGCGGGTTG
GTATTAGTGAT -> TATTAGTGATC
GTCACAGTGAC -> TCACAGTGACG
GTCAGCCATTG -> TCAGCCATTGC
GTCAGCTGGCT -> TCAGCTGGCTT
GTCAGCTTTAT -> TCAGCTTTATG
GTCATTGGATC -> TCATTGGATCT
GTCCAACCTCC -> TCCAACCTCCT
GTCCAACTGGC -> TCCAACTGGCT
GTCCAATTATG -> TCCAATTATGG
GTCCACCGTCT -> TCCACCGTCTT
GTCCACTAGCG -> TCCACTAGCGC
GTCCCAATAAA -> TCCCAATAAAA
GTCCGGGTCTC -> TCCGGGTCTCA
GTCCGTAGGGG -> TCCGTAGGGGA
GTCCTCAAGAA -> TCCTCAAGAAC
GTCCTGCCTAC -> TCCTGCCTACG
GTCGACCGGCG -> TCGACCGGCGG
GTCGCAATCTC -> TCGCAATCTCG
GTCGCAGCAGC -> TCGCAGCAGCT
GTCGCTATGCT -> TCGCTATGCTC
GTCGCTATTTA -> TCGCTATTTAC
GTCGCTCGGTA -> TCGCTCGGTAA
GTCGGAGGAGA -> TCGGAGGAGAG
GTCGGCTACCC -> TCGGCTACCCC
GTCGTCGGCTA -> TCGTCGGCTAC
GTCGTGACACA -> TCGTGACACAA
GTCGTGTTCGA -> TCGTGTTCGAT
GTCTATTCGCC -> TCTATTCGCCC
GTCTCAGGCCC -> TCTCAGGCCCA
GTCTCATGAGC -> TCTCATGAGCA
GTCTGCACCCG -> TCTGCACCCGT
GTCTGGCAAGT -> TCTGGCAAGTC
GTCTGTACACA -> TCTGTACACAT
GTCTTCATCTG -> TCTTCATCTGA
GTCTTGGTAAG -> TCTTGGTAAGG
GTCTTTCCTAC -> TCTTTCCTACA
GTGACACAACC -> TGACACAACCT
GTGACGATAGT -> TGACGATAGTA
GTGACGCAAAG -> TGACGCAAAGA
GTGATCATCTT -> TGATCATCTTT
GTGATGCAGGT -> TGATGCAGGTG
GTGATTTTGGG -> TGATTTTGGGA
GTGCAACTATT -> TGCAACTATTT
GTGCACGAAGG -> TGCACGAAGGT
GTGCAGACTGT -> TGCAGACTGTA
GTGCATTCCTG -> TGCATTCCTGT
GTGCCACACTC -> TGCCACACTCC
GTGCGTCGGAG -> TGCGTCGGAGG
GTGCTCGGTTG -> TGCTCGGTTGC
GTGGCAGCGCC -> TGGCAGCGCCC
GTGGCGCACCC -> TGGCGCACCCG
GTGGCTTTTTG -> TGGCTTTTTGA
GTGGGCTACCA -> TGGGCTACCAC
GTGGTACTCTA -> TGGTACTCTAC
GTGGTAGAGAC -> TGGTAGAGACG
GTGTATCGAGG -> TGTATCGAGGA
GTGTCTGTACA -> TGTCTGTACAC
GTGTGCAACTA -> TGTGCAACTAT
GTGTTCGATCT -> TGTTCGATCTT
GTTACGCAAAA -> TTACGCAAAAT
GTTAGCCAGCT -> TTAGCCAGCTT
GTTATCACCTT -> TTATCACCTTC
GTTATCGAGGG -> TTATCGAGGGG
GTTATCTCCAG -> TTATCTCCAGT
GTTCCCGATCG -> TTCCCGATCGC
GTTCGATCTTC -> TTCGATCTTCA
GTTCGCGAAGC -> TTCGCGAAGCC
GTTCGGCAGCA -> TTCGGCAGCAC
GTTCTATTCTG -> TTCTATTCTGG
GTTCTCATTGA -> TTCTCATTGAT
GTTCTTATCAA -> TTCTTATCAAA
GTTGAAGGAGC -> TTGAAGGAGCG
GTTGAGGCGCA -> TTGAGGCGCAG
GTTGCAAGCAG -> TTGCAAGCAGC
GTTGCGAACGC -> TTGCGAACGCG
GTTGCGTCACA -> TTGCGTCACAG
GTTGCTCGTGG -> TTGCTCGTGGC
GTTGGCATTTC -> TTGGCATTTCA
GTTTACGACTA -> TTTACGACTAG
GTTTGATAGGC -> TTTGATAGGCC
GTTTGGAGACG -> TTTGGAGACGC
GTTTGTAACTA -> TTTGTAACTAC
GTTTTATTTGC -> TTTTATTTGCT
GTTTTTTCTGA -> TTTTTTCTGAA
TAAAAAGACAA -> AAAAAGACAAA
TAAAAAGGGTC -> AAAAAGGGTCC
TAAACAGGGGG -> AAACAGGGGGT
TAAACCCTAGT -> AAACCCTAGTC
TAAACCGTCGC -> AAACCGTCGCT
TAAAGCGGCTG -> AAAGCGGCTGC
TAAATCCGGTT -> AAATCCGGTTA
TAACAAGTAAC -> AACAAGTAACG
TAACCGGATGG -> AACCGGATGGT
TAACGGCACTG -> AACGGCACTGC
TAACTAAATCC -> AACTAAATCCG
TAACTACCCCT -> AACTACCCCTA
TAACTGCCACC -> AACTGCCACCC
TAAGCCAAAGC -> AAGCCAAAGCC
TAAGGCGACCA -> AAGGCGACCAT
TAAGGTTGAGG -> AAGGTTGAGGC
TAAGTTTGGAG -> AAGTTTGGAGA
TAATATCATGA -> AATATCATGAT
TAATCCGATTC -> AATCCGATTCC
TAATTCCGACG -> AATTCCGACGA
TACAAAGGCAT -> ACAAAGGCATT
TACACACTACA -> ACACACTACAT
TACACATCGAG -> ACACATCGAGT
TACACGCACCA -> ACACGCACCAC
TACACGTTCGC -> ACACGTTCGCG
TACAGTAACTA -> ACAGTAACTAA
TACAGTCAGCC -> ACAGTCAGCCA
TACATTACTGC -> ACATTACTGCC
TACCACTGGCC -> ACCACTGGCCT
TACCCCCATTC -> ACCCCCATTCT
TACCCCTATGA -> ACCCCTATGAG
TACCCTACCTC -> ACCCTACCTCA
TACCGTGCTCG -> ACCGTGCTCGG
TACCGTGTGCA -> ACCGTGTGCAA
TACCTCAATTT -> ACCTCAATTTG
TACCTCCCATC -> ACCTCCCATCT
TACGACTAGGA -> ACGACTAGGAA
TACGCAAAATA -> ACGCAAAATAC
TACGCGCGGAG -> ACGCGCGGAGG
TACGCGGGGCC -> ACGCGGGGCCG
TACGGAGCAGT -> ACGGAGCAGTA
TACGGCAGAGC -> ACGGCAGAGCC
TACGTTCTCAT -> ACGTTCTCATT
TACTAATCCGA -> ACTAATCCGAT
TACTCTACGCG -> ACTCTACGCGG
TACTCTACGGC -> ACTCTACGGCA
TACTGCACGTC -> ACTGCACGTCC
TACTGCCTTTG -> ACTGCCTTTGT
TAGAAGTTGCT -> AGAAGTTGCTC
TAGAATACAAA -> AGAATACAAAG
TAGACTAGGAC -> AGACTAGGACG
TAGACTTCGCG -> AGACTTCGCGT
TAGAGACGAAC -> AGAGACGAACT
TAGAGAGGCAA -> AGAGAGGCAAA
TAGAGTCGCAA -> AGAGTCGCAAT
TAGATAATATC -> AGATAATATCA
TAGCACGCCCG -> AGCACGCCCGC
TAGCACGGCTA -> AGCACGGCTAT
TAGCCAGCTTG -> AGCCAGCTTGC
TAGCGCGCTTT -> AGCGCGCTTTG
TAGGAAGCTTA -> AGGAAGCTTAG
TAGGACGAACA -> AGGACGAACAA
TAGGATCAGTT -> AGGATCAGTTC
TAGGCCACCAG -> AGGCCACCAGA
TAGGCGGCTAG -> AGGCGGCTAGA
TAGGGGATCGG -> AGGGGATCGGC
TAGGTTATCAC -> AGGTTATCACC
TAGTATTAGTG -> AGTATTAGTGA
TAGTCTTTCCT -> AGTCTTTCCTA
TAGTGATCATC -> AGTGATCATCT
TAGTTCCCGAT -> AGTTCCCGATC
TATCAAAATCA -> ATCAAAATCAA
TATCACCTTCA -> ATCACCTTCAT
TATCATGATAG -> ATCATGATAGC
TATCCGTCAGC -> ATCCGTCAGCT
TATCGAACCGA -> ATCGAACCGAT
TATCGAGGAAA -> ATCGAGGAAAA
TATCGAGGGGC -> ATCGAGGGGCT
TATCGTTATCT -> ATCGTTATCTC
TATCTACTCTA -> ATCTACTCTAC
TATCTCCAGTC -> ATCTCCAGTCA
TATGACCAAAG -> ATGACCAAAGA
TATGAGAGATG -> ATGAGAGATGT
TATGATGAGAG -> ATGATGAGAGA
TATGCCCAAAA -> ATGCCCAAAAC
TATGCGGGTTG -> ATGCGGGTTGA
TATGCTCCTCG -> ATGCTCCTCGT
TATGGTGCACG -> ATGGTGCACGA
TATGTAAGTTT -> ATGTAAGTTTG
TATTAACCGGA -> ATTAACCGGAT
TATTAGGATCA -> ATTAGGATCAG
TATTAGTGATC -> ATTAGTGATCA
TATTCCTCTAC -> ATTCCTCTACA
TATTCGCCCCT -> ATTCGCCCCTC
TATTCTGGTGC -> ATTCTGGTGCC
TATTTACCTCC -> ATTTACCTCCC
TATTTGCTAGA -> ATTTGCTAGAA
TATTTTAGGTT -> ATTTTAGGTTA
TCAAAATCAAG -> CAAAATCAAGA
TCAACAATCAC -> CAACAATCACA
TCAAGAACCAT -> CAAGAACCATA
TCAAGATTCGA -> CAAGATTCGAT
TCAAGCGTCTT -> CAAGCGTCTTG
TCAATTTGGAG -> CAATTTGGAGG
TCACAGTGACG -> CACAGTGACGA
TCACATACGGA -> CACATACGGAG
TCACATTATCG -> CACATTATCGT
TCACCCGCGAA -> CACCCGCGAAT
TCACCTTCATT -> CACCTTCATTG
TCACGAGGGCT -> CACGAGGGCTT
TCACGCTCACA -> CACGCTCACAT
TCACGGGTACT -> CACGGGTACTA
TCACGTCATTG -> CACGTCATTGG
TCAGCCATTGC -> CAGCCATTGCA
TCAGCTAGAGA -> CAGCTAGAGAG
TCAGCTGGCTT -> CAGCTGGCTTC
TCAGCTTTATG -> CAGCTTTATGT
TCAGTGGCAGC -> CAGTGGCAGCG
TCAGTTCGGCA -> CAGTTCGGCAG
TCATCTGACAA -> CATCTGACAAG
TCATCTTTTTC -> CATCTTTTTCA
TCATGAGCACT -> CATGAGCACTT
TCATGATAGCA -> CATGATAGCAC
TCATGTGACGC -> CATGTGACGCA
TCATGTTCTAT -> CATGTTCTATT
TCATTGATGCA -> CATTGATGCAT
TCATTGGATCT -> CATTGGATCTG
TCATTGTGATT -> CATTGTGATTT
TCCAACCTCCT -> CCAACCTCCTA
TCCAACTGGCT -> CCAACTGGCTA
TCCAAGCCTGA -> CCAAGCCTGAA
TCCAATTATGG -> CCAATTATGGT
TCCACCGTCTT -> CCACCGTCTTC
TCCACTAGCGC -> CCACTAGCGCG
TCCAGCGCGCG -> CCAGCGCGCGG
TCCAGTCAGCT -> CCAGTCAGCTT
TCCATCGCGTC -> CCATCGCGTCC
TCCCAATAAAA -> CCCAATAAAAA
TCCCATCCGCA -> CCCATCCGCAG
TCCCATCTGGC -> CCCATCTGGCT
TCCCCCGGAGA -> CCCCCGGAGAG
TCCCGATCGCA -> CCCGATCGCAT
TCCGACGAGTA -> CCGACGAGTAC
TCCGATTCCTC -> CCGATTCCTCC
TCCGATTGGCG -> CCGATTGGCGG
TCCGCAGACGA -> CCGCAGACGAA
TCCGGGTCTCA -> CCGGGTCTCAT
TCCGGTTATCG -> CCGGTTATCGA
TCCGTAGGGGA -> CCGTAGGGGAT
TCCGTCAGCTG -> CCGTCAGCTGG
TCCTACACACT -> CCTACACACTA
TCCTATCCGTC -> CCTATCCGTCA
TCCTATTAACC -> CCTATTAACCG
TCCTCAAGAAC -> CCTCAAGAACC
TCCTCCAGCGC -> CCTCCAGCGCG
TCCTCGTCCTG -> CCTCGTCCTGC
TCCTCTAAACC -> CCTCTAAACCG
TCCTCTACAGT -> CCTCTACAGTA
TCCTGCCTACG -> CCTGCCTACGT
TCCTGTCTGCA -> CCTGTCTGCAC
TCCTTGTTCTT -> CCTTGTTCTTA
TCGAACCGATC -> CGAACCGATCT
TCGACCATCAC -> CGACCATCACC
TCGACCGGCGG -> CGACCGGCGGT
TCGAGAACTCA -> CGAGAACTCAA
TCGAGGAAAAT -> CGAGGAAAATC
TCGAGGGGCTA -> CGAGGGGCTAC
TCGAGTCCAAT -> CGAGTCCAATT
TCGATAAACCC -> CGATAAACCCT
TCGATCTTCAT -> CGATCTTCATG
TCGATGTTTTA -> CGATGTTTTAT
TCGCAATCTCG -> CGCAATCTCGA
TCGCAGCAGCT -> CGCAGCAGCTC
TCGCATTTGAC -> CGCATTTGACG
TCGCCCCTCCG -> CGCCCCTCCGA
TCGCGAAGCCA -> CGCGAAGCCAA
TCGCGTCCCAA -> CGCGTCCCAAT
TCGCGTTACGC -> CGCGTTACGCA
TCGCTATGCTC -> CGCTATGCTCC
TCGCTATTTAC -> CGCTATTTACC
TCGCTCGGTAA -> CGCTCGGTAAA
TCGCTTAATTC -> CGCTTAATTCC
TCGGAGGAGAG -> CGGAGGAGAGC
TCGGCAGCACC -> CGGCAGCACCG
TCGGCGATTCA -> CGGCGATTCAT
TCGGCTACCCC -> CGGCTACCCCC
TCGGTAAACAG -> CGGTAAACAGG
TCGGTGCAGAC -> CGGTGCAGACT
TCGGTTGCAAG -> CGGTTGCAAGC
TCGTCCTGCCT -> CGTCCTGCCTA
TCGTCGCTATG -> CGTCGCTATGC
TCGTCGGCTAC -> CGTCGGCTACC
TCGTGACACAA -> CGTGACACAAC
TCGTGGCTTTT -> CGTGGCTTTTT
TCGTGTTCGAT -> CGTGTTCGATC
TCGTTATCTCC -> CGTTATCTCCA
TCTAAACCGTC -> CTAAACCGTCG
TCTAAGCCAAA -> CTAAGCCAAAG
TCTACAGTAAC -> CTACAGTAACT
TCTACGCGGGG -> CTACGCGGGGC
TCTACGGCAGA -> CTACGGCAGAG
TCTACTCTACG -> CTACTCTACGG
TCTAGGCGGCT -> CTAGGCGGCTA
TCTATTCGCCC -> CTATTCGCCCC
TCTATTCTGGT -> CTATTCTGGTG
TCTCAGGCCCA -> CTCAGGCCCAT
TCTCATGAGCA -> CTCATGAGCAC
TCTCATTGATG -> CTCATTGATGC
TCTCCAGTCAG -> CTCCAGTCAGC
TCTCGATGTTT -> CTCGATGTTTT
TCTCGCTTAAT -> CTCGCTTAATT
TCTCTTAGAAG -> CTCTTAGAAGT
TCTGAACCATG -> CTGAACCATGA
TCTGACAAGTG -> CTGACAAGTGG
TCTGCACCCGT -> CTGCACCCGTG
TCTGCGCTCAC -> CTGCGCTCACG
TCTGCTACCGT -> CTGCTACCGTG
TCTGGAGAGGG -> CTGGAGAGGGA
TCTGGCAAGTC -> CTGGCAAGTCC
TCTGGCTTCCC -> CTGGCTTCCCC
TCTGGTGCCAC -> CTGGTGCCACA
TCTGTACACAT -> CTGTACACATC
TCTTAGAAGTT -> CTTAGAAGTTG
TCTTATCAAAA -> CTTATCAAAAT
TCTTCATCTGA -> CTTCATCTGAC
TCTTCATGTTC -> CTTCATGTTCT
TCTTCTAGGCG -> CTTCTAGGCGG
TCTTGGTAAGG -> CTTGGTAAGGT
TCTTTCCTACA -> CTTTCCTACAC
TCTTTGGTGTA -> CTTTGGTGTAT
TCTTTTTCAGT -> CTTTTTCAGTG
TGAAAGTCTCA -> GAAAGTCTCAG
TGAACCATGAG -> GAACCATGAGT
TGAACTGCAGT -> GAACTGCAGTT
TGAAGGAGCGG -> GAAGGAGCGGA
TGAAGTTTGTA -> GAAGTTTGTAA
TGACAAGTGGG -> GACAAGTGGGC
TGACACAACCT -> GACACAACCTT
TGACCAAAGAG -> GACCAAAGAGT
TGACGACCAGA -> GACGACCAGAG
TGACGATAGTA -> GACGATAGTAT
TGACGCAAAGA -> GACGCAAAGAA
TGAGAGAAGGG -> GAGAGAAGGGC
TGAGAGATGTC -> GAGAGATGTCT
TGAGCACTTCT -> GAGCACTTCTG
TGAGCCGAATC -> GAGCCGAATCG
TGAGGCGCAGT -> GAGGCGCAGTC
TGAGTCCAACC -> GAGTCCAACCT
TGATAGCACGC -> GATAGCACGCC
TGATAGGCCAC -> GATAGGCCACC
TGATCATCTTT -> GATCATCTTTT
TGATGAGAGAA -> GATGAGAGAAG
TGATGCAGGTG -> GATGCAGGTGG
TGATGCATCAC -> GATGCATCACG
TGATTTTGGGA -> GATTTTGGGAC
TGCAACACGGT -> GCAACACGGTT
TGCAACTATTT -> GCAACTATTTT
TGCAAGCAGCT -> GCAAGCAGCTC
TGCACCCGTGC -> GCACCCGTGCG
TGCACGAAGGT -> GCACGAAGGTG
TGCACGTCCAC -> GCACGTCCACT
TGCAGACTGTA -> GCAGACTGTAT
TGCAGATGAAC -> GCAGATGAACT
TGCAGGTGGTA -> GCAGGTGGTAG
TGCAGTTGGCA -> GCAGTTGGCAT
TGCATCACGGG -> GCATCACGGGT
TGCATCACGTC -> GCATCACGTCA
TGCATTCCTGT -> GCATTCCTGTC
TGCCACACTCC -> GCCACACTCCT
TGCCACCCGAC -> GCCACCCGACA
TGCCAGATTTT -> GCCAGATTTTG
TGCCCAAAACG -> GCCCAAAACGC
TGCCGGAGTAC -> GCCGGAGTACG
TGCCTACGTTC -> GCCTACGTTCT
TGCCTTTGTTT -> GCCTTTGTTTA
TGCGAACGCGC -> GCGAACGCGCT
TGCGCAATGCC -> GCGCAATGCCG
TGCGCTCACGA -> GCGCTCACGAG
TGCGGGTTGAA -> GCGGGTTGAAG
TGCGTCACAGT -> GCGTCACAGTG
TGCGTCGGAGG -> GCGTCGGAGGA
TGCTACCGTGC -> GCTACCGTGCT
TGCTAGAATAC -> GCTAGAATACA
TGCTCCTCGTC -> GCTCCTCGTCC
TGCTCGGTTGC -> GCTCGGTTGCA
TGCTCGTGGCT -> GCTCGTGGCTT
TGGAGACGCCC -> GGAGACGCCCT
TGGAGAGGGAC -> GGAGAGGGACC
TGGAGGCAGGC -> GGAGGCAGGCG
TGGATCTGGAG -> GGATCTGGAGA
TGGCAAGTCCA -> GGCAAGTCCAA
TGGCAGCGCCC -> GGCAGCGCCCG
TGGCATTTCAC -> GGCATTTCACG
TGGCCTGAAAG -> GGCCTGAAAGT
TGGCGCACCCG -> GGCGCACCCGA
TGGCGGAAATC -> GGCGGAAATCG
TGGCTAAGGCG -> GGCTAAGGCGA
TGGCTTCCATC -> GGCTTCCATCG
TGGCTTCCCCC -> GGCTTCCCCCG
TGGCTTTTTGA -> GGCTTTTTGAG
TGGGACGCCGG -> GGGACGCCGGT
TGGGCGGACTG -> GGGCGGACTGC
TGGGCTACCAC -> GGGCTACCACT
TGGTAAGGTTG -> GGTAAGGTTGA
TGGTACTCTAC -> GGTACTCTACG
TGGTAGAGACG -> GGTAGAGACGA
TGGTCGTGACA -> GGTCGTGACAC
TGGTGCACGAA -> GGTGCACGAAG
TGGTGCCACAC -> GGTGCCACACT
TGGTGTATCGA -> GGTGTATCGAG
TGTAACTACCC -> GTAACTACCCC
TGTAAGTTTGG -> GTAAGTTTGGA
TGTACACATCG -> GTACACATCGA
TGTATCGAGGA -> GTATCGAGGAA
TGTATGCCCAA -> GTATGCCCAAA
TGTATGCGGGT -> GTATGCGGGTT
TGTCCACCGTC -> GTCCACCGTCT
TGTCGTCGGCT -> GTCGTCGGCTA
TGTCGTGTTCG -> GTCGTGTTCGA
TGTCTATTCGC -> GTCTATTCGCC
TGTCTGCACCC -> GTCTGCACCCG
TGTCTGTACAC -> GTCTGTACACA
TGTGACGCAAA -> GTGACGCAAAG
TGTGATTTTGG -> GTGATTTTGGG
TGTGCAACTAT -> GTGCAACTATT
TGTTCGATCTT -> GTTCGATCTTC
TGTTCTATTCT -> GTTCTATTCTG
TGTTCTTATCA -> GTTCTTATCAA
TGTTTACGACT -> GTTTACGACTA
TGTTTTATTTG -> GTTTTATTTGC
TTAACCGGATG -> TAACCGGATGG
TTAATTCCGAC -> TAATTCCGACG
TTACCTCCCAT -> TACCTCCCATC
TTACGACTAGG -> TACGACTAGGA
TTACGCAAAAT -> TACGCAAAATA
TTACTGCCTTT -> TACTGCCTTTG
TTAGAAGTTGC -> TAGAAGTTGCT
TTAGAGTCGCA -> TAGAGTCGCAA
TTAGCCAGCTT -> TAGCCAGCTTG
TTAGGATCAGT -> TAGGATCAGTT
TTAGGTTATCA -> TAGGTTATCAC
TTAGTGATCAT -> TAGTGATCATC
TTATCAAAATC -> TATCAAAATCA
TTATCACCTTC -> TATCACCTTCA
TTATCGAGGGG -> TATCGAGGGGC
TTATCGTTATC -> TATCGTTATCT
TTATCTCCAGT -> TATCTCCAGTC
TTATGATGAGA -> TATGATGAGAG
TTATGGTGCAC -> TATGGTGCACG
TTATGTAAGTT -> TATGTAAGTTT
TTATTCCTCTA -> TATTCCTCTAC
TTATTTGCTAG -> TATTTGCTAGA
TTCACGCTCAC -> TCACGCTCACA
TTCAGTGGCAG -> TCAGTGGCAGC
TTCATCTGACA -> TCATCTGACAA
TTCATGTGACG -> TCATGTGACGC
TTCATGTTCTA -> TCATGTTCTAT
TTCATTGTGAT -> TCATTGTGATT
TTCCAAGCCTG -> TCCAAGCCTGA
TTCCATCGCGT -> TCCATCGCGTC
TTCCCCCGGAG -> TCCCCCGGAGA
TTCCCGATCGC -> TCCCGATCGCA
TTCCGACGAGT -> TCCGACGAGTA
TTCCTACACAC -> TCCTACACACT
TTCCTCCAGCG -> TCCTCCAGCGC
TTCCTCTACAG -> TCCTCTACAGT
TTCCTGTCTGC -> TCCTGTCTGCA
TTCGAGAACTC -> TCGAGAACTCA
TTCGATAAACC -> TCGATAAACCC
TTCGATCTTCA -> TCGATCTTCAT
TTCGCCCCTCC -> TCGCCCCTCCG
TTCGCGAAGCC -> TCGCGAAGCCA
TTCGCGTTACG -> TCGCGTTACGC
TTCGGCAGCAC -> TCGGCAGCACC
TTCTAGGCGGC -> TCTAGGCGGCT
TTCTATTCTGG -> TCTATTCTGGT
TTCTCATTGAT -> TCTCATTGATG
TTCTCGCTTAA -> TCTCGCTTAAT
TTCTGAACCAT -> TCTGAACCATG
TTCTGCGCTCA -> TCTGCGCTCAC
TTCTGGTGCCA -> TCTGGTGCCAC
TTCTTATCAAA -> TCTTATCAAAA
TTGAAGGAGCG -> TGAAGGAGCGG
TTGACGACCAG -> TGACGACCAGA
TTGAGCCGAAT -> TGAGCCGAATC
TTGAGGCGCAG -> TGAGGCGCAGT
TTGATAGGCCA -> TGATAGGCCAC
TTGATGCATCA -> TGATGCATCAC
TTGCAAGCAGC -> TGCAAGCAGCT
TTGCAGATGAA -> TGCAGATGAAC
TTGCATCACGG -> TGCATCACGGG
TTGCGAACGCG -> TGCGAACGCGC
TTGCGTCACAG -> TGCGTCACAGT
TTGCTAGAATA -> TGCTAGAATAC
TTGCTCGTGGC -> TGCTCGTGGCT
TTGGAGACGCC -> TGGAGACGCCC
TTGGAGGCAGG -> TGGAGGCAGGC
TTGGATCTGGA -> TGGATCTGGAG
TTGGCATTTCA -> TGGCATTTCAC
TTGGCGGAAAT -> TGGCGGAAATC
TTGGGACGCCG -> TGGGACGCCGG
TTGGGCGGACT -> TGGGCGGACTG
TTGGTAAGGTT -> TGGTAAGGTTG
TTGGTGTATCG -> TGGTGTATCGA
TTGTAACTACC -> TGTAACTACCC
TTGTATGCCCA -> TGTATGCCCAA
TTGTCCACCGT -> TGTCCACCGTC
TTGTGATTTTG -> TGTGATTTTGG
TTGTTCTTATC -> TGTTCTTATCA
TTGTTTACGAC -> TGTTTACGACT
TTTACCTCCCA -> TTACCTCCCAT
TTTACGACTAG -> TTACGACTAGG
TTTAGGTTATC -> TTAGGTTATCA
TTTATGATGAG -> TTATGATGAGA
TTTATGTAAGT -> TTATGTAAGTT
TTTATTTGCTA -> TTATTTGCTAG
TTTCACGCTCA -> TTCACGCTCAC
TTTCAGTGGCA -> TTCAGTGGCAG
TTTCCTACACA -> TTCCTACACAC
TTTCGAGAACT -> TTCGAGAACTC
TTTCTGAACCA -> TTCTGAACCAT
TTTGACGACCA -> TTGACGACCAG
TTTGAGCCGAA -> TTGAGCCGAAT
TTTGATAGGCC -> TTGATAGGCCA
TTTGCTAGAAT -> TTGCTAGAATA
TTTGGAGACGC -> TTGGAGACGCC
TTTGGAGGCAG -> TTGGAGGCAGG
TTTGGGACGCC -> TTGGGACGCCG
TTTGGGCGGAC -> TTGGGCGGACT
TTTGGTGTATC -> TTGGTGTATCG
TTTGTAACTAC -> TTGTAACTACC
TTTGTCCACCG -> TTGTCCACCGT
TTTGTTTACGA -> TTGTTTACGAC
TTTTAGGTTAT -> TTTAGGTTATC
TTTTATGATGA -> TTTATGATGAG
TTTTATTTGCT -> TTTATTTGCTA
TTTTCAGTGGC -> TTTCAGTGGCA
TTTTCTGAACC -> TTTCTGAACCA
TTTTGAGCCGA -> TTTGAGCCGAA
TTTTGGGACGC -> TTTGGGACGCC
TTTTGGGCGGA -> TTTGGGCGGAC
TTTTTCAGTGG -> TTTTCAGTGGC
TTTTTCTGAAC -> TTTTCTGAACC
TTTTTGAGCCG -> TTTTGAGCCGA
TTTTTTCTGAA -> TTTTTCTGAAC